
kmKeystrokeBadAlreadyUsedStr= "The keystroke you have pressed for this hot key conflicts with a hot key in macro ‚Äò%@‚Äô.";
SIVCDescription= "Keyboard Maestro %@ is now available (you have %@).  Would you like to download and install it now?";
InstallFailedStr= "An error occurred while trying to instal the Keyboard Maestro update, redirecting to the download page.";
MacroGroupFrontWindowCondition_ExistsButTitleIsNot= "Available when there is a focused window but its title is not ‚Äú%@‚Äù.";
MacroGroupFrontWindowCondition_TitleContains= "Available when the focused window title contains ‚Äú%@‚Äù.";
MacroGroupFrontWindowCondition_TitleDoesNotContain= "Available when the focused window title does not contain ‚Äú%@‚Äù.";
MacroGroupFrontWindowCondition_ExistsButTitleDoesNotContain= "Available when there is a focused window but its title does not contain ‚Äú%@‚Äù.";
MacroGroupFrontWindowCondition_TitleMatches= "Available when the focused window title matches ‚Äú%@‚Äù.";
MacroGroupFrontWindowCondition_TitleDoesNotMatch= "Available when the focused window title does not match ‚Äú%@‚Äù.";
MacroGroupFrontWindowCondition_ExistsButTitleDoesNotMatch= "Available when there is a focused window but its title does not match ‚Äú%@‚Äù.";
csDeleteClipDataWarningStr= "Are you sure you want to delete the selected clipboard position(s)?";
AskPermissionStr                        = "Keyboard Maestro Engine is Required for Macros to Function";
AskPermissionText                       = "Keyboard Maestro will launch the Keyboard Maestro Engine which is what actually executes your macros and it should continue running after you quit Keyboard Maestro so that your macros continue to operate.\r\rYou only need the Keyboard Maestro editor when you change your macros.\r\rYou can quit the engine at any time by selecting Quit Keyboard Maestro Engine from the Keyboard Maestro status menu.  You should also enable Launch Engine at Login in the preferences so the engine will always be available.\r\rWhat should happen to the engine when you quit the Keyboard Maestro editor?\r";
AskPermissionKeepRunningButton          = "Keep Running";
AskPermissionAlwaysKeepRunningButton    = "Always Keep Running";
WarnAccessibilityTitle= "Accessibility Access is Required";
WarnAccessibilityMessage= "Accessibility access to control your computer is required to use many features including selecting menu items, manipulating windows, pressing buttons, typed string triggers and the window switcher.  Please enable Accessibility for Keyboard Maestro and Keyboard Maestro Engine in the Accessibility section of the Privacy section of the Security & Privacy system preference pane.";
WarnAccessibilityDefaultButton= "Open Preferences";
WarnAccessibilityIgnoreButton= "Later";
WarnAccessibilityNotAgainButton= "Don‚Äôt Ask Again";
UniversalAccessWarningMessage= "Accessibility access to control your computer is required to use many features selecting menu items, manipulating windows, pressing buttons, typed string triggers and the window switcher.\r\rPlease enable Accessibility for Keyboard Maestro and Keyboard Maestro Engine in the Accessibility section of the Privacy section of the Security & Privacy system preference pane.";
UniversalAccessWarningDefaultButton= "Open System Preferences";
WarnKMSwitcherConflictText= "Keyboard Maestro Engine is running and has its own switchers enabled.  These may conflict with the switchers provided by Switcher Maestro, so you might want to disable them.";
WarnPrefWriteFailedText= "Keyboard Maestro failed to write the preferences file. %@ %@ You should quit and fix the problem and then relaunch Keyboard Maestro.";
SharingDisabledBecauseOfNewerWarningMessage= "Syncing macros has been disabled because the macro sync file is from a newer version of Keyboard Maestro.  Update this version of Keyboard Maestro to resume sharing, otherwise your local changes will be destroyed when you do update.";
SecureInputWarningMessageNoWho= "Secure Input is enabled which means the system thinks you are currently in a password field and will not allow applications to monitor the keyboard.\r\rThis will stop typed string triggers from working, as well as stop Keyboard Maestro from sensing your keystrokes while setting hot keys.\r\rYou will need to find the application responsible (often 1Password or LastPass or their Chrome extensions) and quit it.";
SecureInputWarningMessageWithWho= "Secure Input is enabled which means the system thinks you are currently in a password field and will not allow applications to monitor the keyboard.\r\rThis will stop typed string triggers from working, as well as stop Keyboard Maestro from sensing your keystrokes while setting hot keys.\r\rYou will need to find the application responsible (probably %@) and quit it.";
Early1010WarningTitle= "Early Version of Yosemite";
Early1010WarningMessage= "You are running an early version of OS X 10.10 Yosemite.  Versions of Yosemite prior to 10.10.3 had serious bugs in the accessibility preference setting system, making it very difficult to enable accessibility for both Keyboard Maestro and especially Keyboard Maestro Engine.  It is strongly recommended that you upgrade to 10.10.3 or later if at all possible.";
NamedClipboardDeleteWarningMessage= "One or more of the Named Clipboards you are trying to delete is currently in use by a macro.  You can delete it, but it will soon be recreated.";
VariableDeleteWarningMessage= "One or more of the Variables you are trying to delete is currently in use by a macro.  You can delete it, but it may soon be recreated.";
SharingOpenWarningMessage= "Syncing from an existing macro sync file will replace all of your existing macros with the macros from the remote file you select.";
SyncCreateMacrosSuccessMessage= "The macros have been written to the sync file, and will be written whenever the local macros are changed. Any change to the sync file will result in the local macros being replaced from that file.";
SyncOpenMacrosSuccessMessage= "The macros have been replaced with those from sync file, and the macros will be written whenever the local macros are changed. Any change to the sync file will result in the local macros being replaced from that file.";
ShareLibrary_Success_Description0= "The file was written, but no macros were saved.";
ShareLibrary_Success_Description1= "One macro was saved to a library.";
ShareLibrary_Success_Description2= "%d macros were saved to a library.";
ShareActionsOrMacrosFailedHeader= "Failed to export %@.";
ShareActionsOrMacrosFailedMessage= "The attempt to export the %@ failed, the %@ have not been exported.";
ExportMacrosFailedHeader= "Failed to export macros.";
ExportMacrosFailedMessage= "The attempt to export the macros failed, the macros have not been exported.";
ExportMacros_Success_Title= "Exported Macros";
ExportMacros_Success_Description0= "The file was written, but no macros were exported.";
ExportMacros_Success_Description1= "One macro was exported.";
ExportMacros_Success_Description2= "%d macros were exported.";
ExportActionsFailedHeader= "Failed to export actions.";
ExportActionsFailedMessage= "The attempt to export the actions failed, the actions have not been exported.";
ExportActions_Success_Title= "Exported Actions";
ExportActions_Success_Description0= "The file was written, but no actions were exported.";
ExportActions_Success_Description1= "One action was exported.";
ExportActions_Success_Description2= "%d actions were exported.";
ImportActions_Success_Title= "Imported Actions";
ImportActions_Success_Description0= "The file was written, but no actions were importeded.";
ImportActions_Success_Description1= "One action was importeded.";
ImportActions_Success_Description2= "%d actions were importeded.";
ImportActions_CantImportErrorTitle= "Cannot Import Actions File";
ImportActions_CantImportError_UnknownExplanation= "The Actions File you selected is of an unknown format.";
ImportMacros_CantImportErrorTitle= "Cannot Import Macro File";
ImportMacros_CantImportError_UnknownExplanation= "The Macro File you selected is of an unknown format.";
ImportMacros_Success_Title= "Imported Macros";
ImportLibrary_CantImportErrorTitle= "Cannot Import Library File";
ImportLibrary_CantImportError_UnknownExplanation= "The Library File you select is of an unknown format.";
ImportLibrary_Success_Title= "Inserted Library";
Import_Success_Description000= "The file was read, but no macros were imported.";
Import_Success_Description001= "One smart group imported.";
Import_Success_Description002= "%%d smart groups imported.";
Import_Success_Description110= "One macro was imported.";
Import_Success_Description111= "One macro and one smart group were imported.";
Import_Success_Description112= "One macro and %%d smart groups were imported.";
Import_Success_Description210= "%d macros were imported into one macro group.";
Import_Success_Description211= "%d macros were imported into one macro group and one smart group was imported.";
Import_Success_Description212= "%d macros were imported into one macro group and %%d smart groups were imported.";
Import_Success_Description220= "%d macros were imported into %d macro groups.";
Import_Success_Description221= "%d macros were imported into %d macro groups and one smart group was imported.";
Import_Success_Description222= "%d macros were imported into %d macro groups and %%d smart groups were imported.";
MacroGroupDefaultName_GlobalTarget= "Macros for All Applications";
MacroGroupDefaultName_SpecificApps= "Macros for ";
MacroGroupDefaultName_ExcludedApps= "Macros Not Active In ";
MacroGroupDefaultName_AppSeperator= ", ";
NagWindowTitle= "Keyboard Maestro %@";
InvalidSerialMessage= "Make sure you enter your email address and serial number exactly as they appear on your registration acknowledgment email.";
OldSerialMessage= "The username and serial number you have entered is valid for an older version, you will need to enter your new serial number.";
PSShowMenu= "Show (s)";
PSHideMenu= "Hide (h)";
PSLaunchMenu= "Launch (l)";
PSLaunchAndHideOthersMenu= "Launch & Hide Others (d)";
PSSwitchMenu= "Activate (l)";
PSSwitchAndHideOthersMenu= "Activate & Hide Others (d)";
ALLaunchMenu= "Launch";
ALLaunchAndHideOthersMenu= "Launch & Hide Others";
SIVCLanguage= "EN";
MacAppStoreVersion= "Mac App Store Version";
apmMore= "More‚Ä¶";
DefaultSearchTitle= "Search the web with Google";
DefaultSearchURL= "https://www.google.com/search?q=%Search%";
hkExecuteJavaScriptForCustomPrompt= "Execute a JavaScript in Custom Prompt";
hkExecuteJavaScriptForCustomPromptAll= "Execute a JavaScript in all Custom Prompts";
hkExecuteJavaScriptForCustomPromptTitle= "Execute a JavaScript in Custom Prompt with ID ‚Äò%@‚Äô";
hkSetClipboardToNamedClipboard= "Set Clipboard to Named Clipboard"; // depricated
hkSaveClipboardToNamedClipboard= "Save Clipboard to Named Clipboard"; // depricated
SelectMenuApplicationNotFound= "Select Menu Item failed to find target application for %@.";
SelectMenuApplicationNotFoundApp= "Select Menu Item failed to find target application ‚Äò%@‚Äô for %%@.";
SelectMenuBarNotFound= "Select Menu Item failed to find target menu bar for %@.";
SelectMenuItemNotFound= "Select Menu Item failed to find target menu item %@.";
SelectMenuItemDisabled= "Select Menu Item failed because the menu item %@ is disabled.";
SelectMenuItemFailed= "Menu selection failed to pick menu %@ with error %ld.";
SelectMenuItemRequiresAccess= "Select Menu Item action requires Accessibility which is disabled.";
PressButtonWindowNotFound= "Press Button ‚Äò%@‚Äô failed to find window.";
PressButtonButtonNotFound= "Press Button ‚Äò%@‚Äô failed to find button.";
PressButtonDisabled= "Press Button ‚Äò%@‚Äô failed because the button is disabled.";
PressButtonRequiresAccess= "Press Button action requires Accessibility which is disabled.";
MouseClickNoFrontWindow= "Move or Click Mouse no front window found.";
MouseClickNoImageFound= "Move or Click Mouse no unique image found.";
MouseClickNoImage= "Move or Click Mouse no image specified.";
MouseClickCalculateFailed= "Move or Click Mouse calculation %@ failed.";
TimeoutExceeded= "Action timeout exceeded.";
MacroCancelledFormat= "%@ Macro ‚Äò%@‚Äô cancelled (while executing %@).";
ActionFailedFormat= "%@ In macro ‚Äò%@‚Äô (while executing %@).";
kmModifierKeySeparator= "";
kmFKeyFormat= "F%d";
kmModifierControl= "Control";
kmModifierOption= "Option";
kmModifierShift= "Shift";
kmModifierCommand= "Command";
kmHiliteLocationTitleRectangle= "Highlight Rectangle at %@,%@,%@,%@";
kmHiliteLocationTitleOval= "Highlight Oval at %@,%@,%@,%@";
kmHiliteLocationTitleTarget= "Highlight Target at %@,%@,%@,%@";
kmExecuteAppleScriptType= "AppleScript";
kmExecuteJavaScriptType= "JavaScript in %@";
kmExecuteShellScriptType= "Shell Script";
kmExecuteJavaScriptForAutomationType= "JavaScript For Automation";
kmExecuteSwiftScriptType= "Swift Script";
//kmExecuteBaseScriptFileFormatResultsDescription= "The output of script ‚Äò%@‚Äô is:";
//kmExecuteBaseScriptTextScriptResultsDescription= "The output of the text script is:";
kmExecuteJavaScriptForCustomPromptResultsDescription= "The output of the script is:";
kmExecuteJavaScriptForCustomPromptResultsTitle= "JavaScript Results";
kMacroGroupToggleInternalAutomatic= "Internal Toggle Macro Group";
kMacroGroupToggleOnce= "Activate Macro Group for One Action";
kMacroGroupToggleActivate= "Activate Macro Group";
kMacroGroupToggleDeactivate= "Deactivate Macro Group";
kMacroGroupToggleToggle= "Activate/Deactivate Macro Group";
kMacroGroupToggleOnceWithPalette= "Show Macro Group for One Action";
kMacroGroupToggleShowPalette= "Show Macro Group";
kMacroGroupToggleHidePalette= "Hide Macro Group";
kMacroGroupToggleTogglePalette= "Show/Hide Macro Group";
kMacroGroupToggleInternalAutomaticFormat= "Internal Toggle Macro Group ‚Äò%@‚Äô";
kMacroGroupToggleOnceFormat= "Activate Macro Group ‚Äò%@‚Äô for One Action";
kMacroGroupToggleActivateFormat= "Activate Macro Group ‚Äò%@‚Äô";
kMacroGroupToggleDeactivateFormat= "Deactivate Macro Group ‚Äò%@‚Äô";
kMacroGroupToggleToggleFormat= "Activate/Deactivate Macro Group ‚Äò%@‚Äô";
kMacroGroupToggleOnceWithPaletteFormat= "Show Macro Group ‚Äò%@‚Äô for One Action";
kMacroGroupToggleShowPaletteFormat= "Show Macro Group ‚Äò%@‚Äô";
kMacroGroupToggleHidePaletteFormat= "Hide Macro Group ‚Äò%@‚Äô";
kMacroGroupToggleTogglePaletteFormat= "Show/Hide Macro Group ‚Äò%@‚Äô";
kmReadFileToClipboardTitleFormat= "Read File to Clipboard";
kmReadFileToNamedClipboardTitleFormat= "Read File to Named Clipboard ‚Äò%@‚Äô";
kmReadFileToVariableTitleFormat= "Read File to Variable ‚Äò%@‚Äô";
kmWriteFileFromClipboardTitleFormat= "%@ Clipboard";
kmWriteFileFromNamedClipboardTitleFormat= "%@ Named Clipboard ‚Äò%@‚Äô";
kmWriteFileFromVariableTitleFormat= "%@ Variable ‚Äò%@‚Äô";
kmWriteFileFromPlainTextTitleFormat= "%@ Text";
kmWriteFileFromStyledTextTitleFormat= "%@ Styled Text";
kmWriteFileMakeLongTitleFormat= "%@ to File";
kmActionTextSourceClipboard= "%@ of Clipboard";
kmActionTextSourceNamedClipboardFormat= "%@ of Named Clipboard ‚Äò%@‚Äô";
kmActionTextSourceVariableFormat= "%@ of Variable ‚Äò%@‚Äô";
kmActionTextSourceTextFormat= "%@ of Text ‚Äò%@‚Äô";
kmSubstringActionName= "Get Substring";
kmSwitchActionName= "Switch";
kmSubstringDestinationHTMLClipboard= "Store result to Clipboard";
kmSubstringDestinationHTMLNamedClipboardFormat= "Store result to Named Clipboard ‚Äò%@‚Äô";
kmSubstringDestinationHTMLVariableFormat= "Store result to Variable ‚Äò%@‚Äô";
kmCompositeImageClipboard= "Composite Clipboard onto Image";
kmCompositeImageText= "Composite Text onto Image";
kmCompositeImageHTMLClipboard= "Composite %@ onto Image in %@";
kmCompositeImageHTMLText= "Composite Text onto Image in %@";
kmNewFolderTitleLongFormat= "Create New Folder ‚Äò%@‚Äô";
kClipboardTargetNamedClipboardFormat= "Named Clipboard ‚Äò%@‚Äô";
kmApplyStyleHTMLDescriptionTitleFormat= "Apply Style to %@";
kmApplyTextFactoryHTMLDescriptionTitleFormat= "Apply Text Factory to %@";
kApplyStyleToTo= "Apply up to character %@";
kApplyStyleToFrom= "Apply from character %@";
kApplyStyleToLast= "Apply to last %@ characters";
kApplyStyleToRange= "Apply from character %@ length %@";
kApplyStyleToFromTo= "Apply from character %@ to character %@";
kSubstringRangeTo= "Subrange up to character %@";
kSubstringRangeFrom= "Subrange from character %@";
kSubstringRangeLast= "Subrange of last %@ characters";
kSubstringRangeRange= "Subrange from character %@ length %@";
kSubstringRangeFromTo= "Subrange from character %@ to character %@";
kSubstringRangeDeleteTo= "Subrange deleting up to character %@";
kSubstringRangeDeleteFrom= "Subrange deleting from character %@";
kSubstringRangeDeleteLast= "Subrange deleting last %@ characters";
kSubstringRangeDeleteRange= "Subrange deleting from character %@ length %@";
kSubstringRangeDeleteFromTo= "Subrange deleting from character %@ to character %@";
hkTrimImageHTMLTitle= "Trim Image in %@";
kmNewImageHTMLDescriptionTitleFormat= "Create New Image in %@";
kmDisplayImageFormat= "Display %@";
kmSetNetworkLocationFormat= "Set Network Location to ‚Äò%@‚Äô";
kmGetFileAttributeTitleFormat= "Get %@ to Variable ‚Äò%@‚Äô";
kmSetFileAttributeTitleFormat= "Set %@ to ‚Äò%@‚Äô";
kmOpen1FileTitleFormat= "Open ‚Äò%@‚Äô";
kmOpenPrefPaneTitleFormat= "Open %@ Preference Pane";
kmOpen1PasswordTitleFormat= "Open 1Password Bookmark %@‚Äô";
kmForTitle= "For Each Item in a Collection Execute Actions";
kmForHTMLTitle0= "For Each With No Collections Will Do Nothing";
kmForHTMLTitle1= "For Each Item in the Collection Execute Actions";
kmForHTMLTitle2= "For Each Item in these Collections Execute Actions";
kmSwitchIsDescription= "If it Is ‚Äú%@‚Äù";
kmSwitchIsNotDescription= "If it Is Not ‚Äú%@‚Äù";
kmSwitchContainsDescription= "If it Contains ‚Äú%@‚Äù";
kmSwitchDoesNotContainDescription= "If it Does Not Contain ‚Äú%@‚Äù";
kmSwitchMatchesDescription= "If it Matches ‚Äú%@‚Äù";
kmSwitchDoesNotMatchDescription= "If it Does Not Match ‚Äú%@‚Äù";
kmSwitchConformsToDescription= "If it Conforms To ‚Äú%@‚Äù";
kmSwitchDoesNotConformToDescription= "If it Does Not Conform To ‚Äú%@‚Äù";
hkDebuggerActionStepOverOthersTitle= "Debugger Step Over Other Macros";
hkDebuggerActionStepIntoOthersTitle= "Debugger Step Into Other Macros";
hkDebuggerActionStepOutOthersTitle= "Debugger Step Out Other Macros";
hkSpeakTextTitle= "Speak Text ‚Äò%@‚Äô";
hkSpeakTextVoiceTitle= "Speak Text With Voice ‚Äò%@‚Äô at %@ Rate";
hkSpeakTextDefaultVoiceTitle= "Speak Text With Default Voice ‚Äò%@‚Äô at %@ Rate";
hkSystemVolumeTitleFormat= "Set System Output Volume to %d%%";
hkSendMIDIMessageNoteOnTitleFormat= "Send MIDI channel %d note %d velocity %d";
hkSendMIDIMessageNoteOffTitleFormat= "Send MIDI channel %d note %d off";
hkSendMIDIMessageControlChangeTitleFormat= "Send MIDI channel %d control %d change to %d";
hkSendMIDIMessageNoteOnTitle= "Send MIDI Note On";
hkSendMIDIMessageNoteOffTitle= "Send MIDI Note Off";
hkSendMIDIMessageControlChangeTitle= "Send MIDI Control Change";
QuickTimePlayerCmd_StepForward_Title= "Step Forward Current Movie %@ Frames";
QuickTimePlayerCmd_StepForward_ShortTitle= "Step Forward Current Movie";
QuickTimePlayerCmd_StepBackward_Title= "Step Backward Current Movie %@ Frames";
QuickTimePlayerCmd_StepBackward_ShortTitle= "Step Backward Current Movie";
QuickTimePlayerCmd_IncreaseVolume_Title= "Increase Current Movie Volume by 10%";
QuickTimePlayerCmd_IncreaseVolume_ShortTitle= "Increase Current Movie Volume";
QuickTimePlayerCmd_DecreaseVolume_Title= "Decrease Current Movie Volume by 10%";
QuickTimePlayerCmd_DecreaseVolume_ShortTitle= "Decrease Current Movie Volume";
QuickTimePlayerCmd_SetVolume_TitleFormat= "Set Current Movie Volume to %d%%";
QuickTimePlayerCmd_SetVolume_Title= "Set Current Movie Volume";
aManipulateWindow_ResizeWindowByPercentFormat= "Scale %@ by Percent";
aManipulateWindow_ResizeWindowByFormat= "Resize %@ by Pixels";
aManipulateWindow_ResizeWindowToFormat= "Resize %@ to Pixels";
aManipulateWindow_MoveWindowByFormat= "Move %@ by Pixels";
aManipulateWindow_MoveWindowToFormat= "Move %@ to Position";
aManipulateWindow_MoveAndResizeFormat= "Move and Resize %@";
aManipulateWindow_CenterWindowFormat= "Center %@";
aManipulateWindow_CenterWindowAtFormat= "Center %@ at Position";
aManipulateWindow_CloseWindowFormat= "Close %@";
aManipulateWindow_ZoomWindowFormat= "Zoom %@";
aManipulateWindow_ReallyMinimizeWindowFormat= "Minimize %@";
aManipulateWindow_UnminimizeWindowFormat= "Unminimize %@";
aManipulateWindow_SelectWindowFormat= "Bring %@ to Front";
aManipulateWindow_FrontWindowName= "Front Window";
aManipulateWindow_NamedWindowFormat= "Window Named ‚Äò%@‚Äô";
aManipulateWindow_WindowWithNameContainingFormat = "Window(s) With Name Containing ‚Äò%@‚Äô";
aManipulateWindow_WindowWithIndexFormat= "Window With Index %@";
aManipulateWindow_New_SelectWindow= "Bring a Window to the Front";
kmScreenCaptureTitle= "Screen Capture %@";
kmScreenCaptureSourceScreenMain= "Screen Capture Main Screen";
kmScreenCaptureSourceScreenIndex= "Screen Capture Screen %@";
kmScreenCaptureSourceWindowFront= "Screen Capture Front Window";
kmScreenCaptureSourceWindowIndex= "Screen Capture Window %@";
kmScreenCaptureSourceWindowName= "Screen Capture Window ‚Äò%@‚Äô";
kmScreenCaptureSourceWindowNameContaining= "Screen Capture Window With Name Containing ‚Äò%@‚Äô";
kmScreenCaptureSourceWindowNameMatching= "Screen Capture Window With Name Matching ‚Äò%@‚Äô";
kHScreenAreaScreenIndexDescription= "Screen %@";
kHScreenAreaWindowNameDescription= "Window ‚Äò%@‚Äô";
kHScreenAreaWindowNameContainingDescription= "Window With Name Containing ‚Äò%@‚Äô";
kHScreenAreaWindowNameMatchingDescription= "Window With Name Matching ‚Äò%@‚Äô";
kHScreenAreaWindowIndexDescription= "Window %@";
kHScreenAreaAreaDescription= "Area (%@)";
kmDrawImageActionLine= "Draw a Line onto Image";
kmDrawImageActionRectangle= "Draw a Rectangle onto Image";
kmDrawImageActionOval= "Draw a Oval onto Image";
kmDrawImageActionHTML= "Draw onto Image in %@";
kmDrawImageLineHTML= "Draw a line from (%@,%@) to (%@,%@), %@ thick.";
kmDrawImageRectangleHTML= "Draw a rectangle from (%@,%@), %@ wide, %@ high, %@ thick.";
kmDrawImageOvalHTML= "Draw an oval centered (%@,%@), %@ wide, %@ high.";
kmTransformImageActionHTMLFlipHorizontal= "Flip Image in %@ Horizontally";
kmTransformImageActionHTMLFlipVertical= "Flip Image in %@ Vertically";
kmTransformImageActionHTMLRotateCW= "Rotate Image in %@ Clockwise";
kmTransformImageActionHTMLRotate180= "Rotate Image in %@ 180¬∞";
kmTransformImageActionHTMLRotateCCW= "Rotate Image in %@ Counter-Clockwise";
kmTransformImageActionHTMLFreeRotate= "Rotate Image in %@ by ‚Äò%@‚Äô";
kmGetImageSize= "Get Image %@ of %@";
kmResizeImageActionHTMLScaleTo= "Resize Image in %@";
kmResizeImageActionHTMLResizeTo= "Resize Canvas in %@";
kmResizeImageActionHTMLAddMargin= "Add or Remove Margins to Image in %@";
kmResizeImageActionHTMLCrop= "Crop Image in %@";
aSummaryReturnFormat= "%@‚Ü©";
aSummaryTextFormat= "%@‚Ä¶";
aInsertText_DisplayDescription= "The text is:";
aFastUserSwitch_DescriptionFormat= "Fast User Switch to ‚Äò%@‚Äô";
aSetKeyboardLayout_DescriptionFormat= "Set Keyboard Layout to ‚Äò%@‚Äô";
kmSimulateHardwareKeyPressAndReleaseTitleFormat= "Simulate the Hardware Key %@";
kmSimulateHardwareKeyPressAndHoldTitleFormat= "Press and Hold the Hardware Key %@";
kmSimulateHardwareKeyPressAndRepeatTitleFormat= "Press and Repeat the Hardware Key %@";
kmSimulateHardwareKeyReleaseTitleFormat= "Release the Hardware Key %@";
aSetClipboardToText_StyledText= "Styled Text";
aSetClipboardToText_DescriptionFormat= "Set %@ to %@";
aSetClipboardToText_DescriptionExtendedFormat= "%@ ‚Äò%@‚Äô";
aSetClipboardToText_DisplayDescription= "The clipboard would be:";
aSetVariableToText_DescriptionFormat= "Set Variable ‚Äò%@‚Äô to Text ‚Äò%@‚Äô";
aSetVariableToText_HTMLFormat= "Set Variable ‚Äò%@‚Äô to Text";
aSetVariableToSafariField_DescriptionFormat= "Set Variable ‚Äò%@‚Äô to %@ Field ‚Äò%@‚Äô";
aSetVariableToSafariField_NewActionFormat= "Set Variable to %@ Field";
aSetVariableToCalculation_DescriptionFormat= "Set Variable ‚Äò%@‚Äô To Calculation ‚Äò%@‚Äô";
aSetActionDelay00_DescriptionFormat= "Set %@ Delay for This Macro to %@ Seconds";
aSetActionDelay01_DescriptionFormat= "Set %@ Delay Globally to %@ Seconds";
aSetActionDelay10_DescriptionFormat= "Reset %@ Delay for This Macro to %@ Seconds";
aSetActionDelay11_DescriptionFormat= "Reset %@ Delay Globally to %@ Seconds";
aSetFindPasteboard_DescriptionFormat= "Set Find Pasteboard to Text ‚Äò%@‚Äô";
aSetVariableToKeychainPassword_DescriptionFormat= "Set Variable ‚Äò%@‚Äô to Keychain Password ‚Äò%@‚Äô";
aSetKeychainPasswordToText_DescriptionFormat= "Set Keychain Password ‚Äò%@‚Äô to Text ‚Äò%@‚Äô";
aSetSafariFieldToText_DescriptionFormat= "Set %@ Field ‚Äò%@‚Äô to Text";
aSetSafariFieldToText_NewActionFormat= "Set %@ Field to Text";
aSetSafariCheckbox_DescriptionCheckedFormat= "Set %@ Checkbox ‚Äò%@‚Äô to checked";
aSetSafariCheckbox_DescriptionUncheckedFormat= "Set %@ Checkbox ‚Äò%@‚Äô to unchecked";
aSetSafariCheckbox_DescriptionValueFormat= "Set %@ Checkbox ‚Äò%@‚Äô to ‚Äò%@‚Äô";
aSetSafariCheckbox_NewActionFormat= "Set %@ Checkbox";
aSetSafariRadio_DescriptionFormat= "Set %@ Radio Button ‚Äò%@‚Äô to ‚Äò%@‚Äô";
aSetSafariRadio_NewActionFormat= "Set %@ Radio Button";
kSetMailStatus_DescriptionOnFormat = "Set Mail %@ to On";
kSetMailStatus_DescriptionOffFormat = "Set Mail %@ to Off";
kSetMailStatus_DescriptionFormat = "Set Mail %@ to %@";
kMailFlagIndex= "Flag Index";
kMailFlagged= "Flagged Status";
kMailJunk= "Junk Status";
kMailRead= "Read Status";
kMailStatus0= "Off";
kMailStatus1= "On";
kMailFlagIndex0= "Unflagged";
kMailFlagIndex1= "Red";
kMailFlagIndex2= "Oragne";
aMailSendMessage_DescriptionFormat= "Send Mail Message with Subject ‚Äò%@‚Äô";
aExecuteJavaScript_NewActionFormat= "Execute a JavaScript in %@";
aPromptForUserInput_Format= "Prompt for User Input ‚Äò%@‚Äô";
hkFilterClipboardTitleFormat= "Filter %@ with %@";
hkFilterVariableTitleFormat= "Filter Variable ‚Äò%@‚Äô with %@";
kFilterRemoveStyles= "Remove Styles";
kFilterMacLineEndings= "Mac Line Endings";
kFilterUnixLineEndings= "Unix Line Endings";
kFilterWindowsLineEndings= "Windows Line Endings";
kFilterTrimWhitespace= "Trim Whitespace";
kFilterUnwrap= "Unwrap";
kFilterLowercase= "Lowercase";
kFilterLowercaseFirst= "Lowercase First";
kFilterUppercase= "Uppercase";
kFilterUppercaseFirst= "Uppercase First";
kFilterTitleCase= "Title Case";
kFilterDumbQuotes= "Dumb Quotes";
kFilterFrenchQuotes= "French Quotes";
kFilterSpaces= "Spaces";
kFilterTabs= "Tabs";
kFilterEncodeHTMLEntities= "Encode HTML Entities";
kFilterEncodeNonASCIIHTMLEntities= "Encode Non-ASCII HTML Entities";
kFilterDecodeHTMLEntities= "Decode HTML Entities";
kFilterMakeHTMLList= "HTML List";
kFilterPercentEncodeForURL= "Percent Encode for URL";
kFilterPercentDecodeURL= "Percent Decode URL";
kFilterQuoteForAppleScript= "Quote for AppleScript";
kFilterQuoteForJavaScript= "Quote for JavaScript";
kFilterQuoteForShellScript= "Quote for Shell Script";
kFilterQuoteForSwift= "Quote for Swift";
kFilterLastPathComponent= "Last Path Component";
kFilterDeleteLastPathComponent= "Delete Last Path Component";
kFilterPathExtension= "Path Extension";
kFilterDeletePathExtension= "Delete Path Extension";
kFilterExpandTildeInPath= "Expand Tilde In Path";
kFilterAbbreviateWithTildeInPath= "Abbreviate With Tilde In Path";
kFilterResolveSymlinks= "Resolve Symlinks";
kFilterStandardizePath= "Standardize Path";
kFilterZapControlCharacters= "Zap Control Characters";
kFilterBulletControlCharacters= "Bullet Control Characters";
kFilterCalculate= "Calculate";
kFilterProcessTokens= "Process Tokens";
kFilterValueOfNamedVariable= "Value of Named Variable";
kFilterValueOfNamedClipboard= "Value of Named Clipboard";
kFilterCharacterCount= "Character Count";
kFilterLineCount= "Line Count";
SearchReplaceClipboardActionType::kCaseSensitiveString= "Search and Replace %@ With String Matching (case sensitive)";
SearchReplaceClipboardActionType::kIgnoreCaseString= "Search and Replace %@ With String Matching (ignoring case)";
SearchReplaceClipboardActionType::kCaseSensitiveRegEx= "Search and Replace %@ Using Regular Expression (case sensitive)";
SearchReplaceClipboardActionType::kIgnoreCaseRegEx= "Search and Replace %@ Using Regular Expression (ignoring case)";
SearchReplaceVariableActionType::kCaseSensitiveString= "Search and Replace Variable ‚Äò%@‚Äô With String Matching (case sensitive)";
SearchReplaceVariableActionType::kIgnoreCaseString= "Search and Replace Variable ‚Äò%@‚Äô With String Matching (ignoring case)";
SearchReplaceVariableActionType::kCaseSensitiveRegEx= "Search and Replace Variable ‚Äò%@‚Äô Using Regular Expression (case sensitive)";
SearchReplaceVariableActionType::kIgnoreCaseRegEx= "Search and Replace Variable ‚Äò%@‚Äô Using Regular Expression (ignoring case)";
SearchVariableActionType::kCaseSensitiveRegEx= "Search Variable ‚Äò%@‚Äô Using Regular Expression (case sensitive)";
SearchVariableActionType::kIgnoreCaseRegEx= "Search Variable ‚Äò%@‚Äô Using Regular Expression (ignoring case)";
SearchClipboardActionType::kCaseSensitiveRegEx= "Search %@ Using Regular Expression (case sensitive)";
SearchClipboardActionType::kIgnoreCaseRegEx= "Search %@ Using Regular Expression (ignoring case)";
UseVariableActionType::kSetMouse= "Use Variable ‚Äò%@‚Äô to Set the Mouse Location";
UseVariableActionType::kSetWindowPosition= "Use Variable ‚Äò%@‚Äô to Set the Front Window Position";
UseVariableActionType::kSetWindowSize= "Use Variable ‚Äò%@‚Äô to Set the Front Window Size";
UseVariableActionType::kSetWindowFrame= "Use Variable ‚Äò%@‚Äô to Set the Front Window Frame";
UseVariableActionType::kSetWindowByName= "Use Variable ‚Äò%@‚Äô to Set the Front Window by Name";
UseVariableActionType::kSetWindowByNameContains= "Use Variable ‚Äò%@‚Äô to Set the Front Window by Name Contains";
UseVariableActionType::kSetWindowByNameMatches= "Use Variable ‚Äò%@‚Äô to Set the Front Window by Name Matching";
UseVariableActionType::kSetApplicationByName= "Use Variable ‚Äò%@‚Äô to Set the Front Application by Name";
UseVariableActionType::kSetApplicationByNameContains= "Use Variable ‚Äò%@‚Äô to Set the Front Application by Name Containing";
UseVariableActionType::kSetApplicationByNameMatches= "Use Variable ‚Äò%@‚Äô to Set the Front Application by Name Matching";
UseVariableActionType::kSetSystemVolume= "Use Variable ‚Äò%@‚Äô to Set the System Volume";
WriteFileFormatRTF= "RTF";
WriteFileFormatRTFD= "RTFD";
WriteFileFormatSimpleText= "Simple Text";
WriteFileFormatHTML= "HTML";
WriteFileFormatWebArchive= "Web Archive";
WriteFileFormatWordDoc= "Word Doc";
WriteFileFormatWordML= "Word ML";
WriteFileFormatOfficeOpenXML= "Office Open XML";
WriteFileFormatOpenDocument= "Open Document";
WriteFileFormatPNG= "PNG";
WriteFileFormatTIFF= "TIFF";
WriteFileFormatJPEG= "JPEG";
WriteFileFormatBMP= "BMP";
WriteFileFormatGIF= "GIF";
WriteFileEncodingMacRoman= "Mac Roman";
WriteFileEncodingLatin1= "ISO Latin 1";
WriteFileEncodingUTF8= "UTF8";
WriteFileEncodingUTF16= "UTF16";
aQuickMacro_DescriptionFormat= "Record Quick Macro for Hot Key %@";
aQuickMacro_TargetNameFormat= "%@ [Quick Macro]";
aMacroGroupToggle_TargetNameFormat= "%@ [Macro Group]";
aPressButton_DescriptionFormat= "Press Button ‚Äò%@‚Äô";
hkSemaphoreLock_DescriptionFormat= "Semaphore Lock ‚Äò%@‚Äô";
hkSemaphoreUnlock_DescriptionFormat= "Semaphore Unlock ‚Äò%@‚Äô";
hkSemaphoreReset_DescriptionFormat= "Semaphore Reset ‚Äò%@‚Äô";
SemaphoreUnlockFailed= "Semaphore Unlock ‚Äò%@‚Äô failed on unlocked semaphore";
aCSMacroAction_PasteFormat= "Paste from Named Clipboard ‚Äò%@‚Äô";
aCSMacroAction_CopyFormat= "Copy to Named Clipboard ‚Äò%@‚Äô";
aCSMacroAction_CutFormat= "Cut to Named Clipboard ‚Äò%@‚Äô";
aCSMacroAction_PasteTitle= "Paste from Named Clipboard";
aCSMacroAction_CopyTitle= "Copy to Named Clipboard";
aCSMacroAction_CutTitle= "Cut to Named Clipboard";
aSetClipboardToNamedClipboardFormat= "Set Clipboard to Named Clipboard ‚Äò%@‚Äô";
aSaveClipboardToNamedClipboardFormat= "Save Clipboard to Named Clipboard ‚Äò%@‚Äô";
aSetClipboardToPastClipboardFormat= "Set %@ to Past Clipboard %@";
aCopyClipboardNothing= "Copy Nothing";
aCopyClipboard= "Copy %@ to %@";
aDeletePastClipboardFormat= "Delete Past Clipboard %@";
UnitsIn1Second= "1 second";
UnitsInSeconds= "%d seconds";
UnitsIn1Minute= "1 minute";
UnitsInMinutes= "%d minutes";
UnitsIn1Hour= "1 hour";
UnitsInHours= "%d hours";
UnitsIn1Day= "1 day";
UnitsInDays= "%d days";
tUSBDeviceTriggerTitle= "USB Device Trigger";
tVolumeTriggerTitle= "Mounted Volume Trigger";
tFocusedWindowTriggerTitle= "Focused Window Trigger";
tFolderTriggerTitle= "Folder Trigger";
tHIDTriggerTitle= "Device Trigger";
tTypedStringTriggerTitle= "Typed String Trigger";
tApplicationTriggerTitle= "Application Trigger";
tTimeTriggerTitle= "Time of Day Trigger";
tWhileLoggedInTriggerTitle= "While Logged In Trigger";
tLoginTriggerTitle= "Login Trigger";
tLaunchTriggerTitle= "Launch Trigger";
tGlobalMacroPaletteTitle= "Global Macro Palette Trigger";
tStatusMenuTitle= "Status Menu Trigger";
tWakeTitle= "Wake Trigger";
tSleepTitle= "Sleep Trigger";
tClipboardTitle= "Clipboard Trigger";
tPublicWebTitle= "Public Web Trigger";
tScriptTitle= "Script Trigger";
tWirelessNetworkTriggerTitle= "Wireless Network Trigger";
tHotKeyTriggerDescPressedFormat= "The Hot Key %@ is pressed";
tHotKeyTriggerDescWhileDownFormat= "While the Hot Key %@ is down";
tHotKeyTriggerDescReleasedFormat= "The Hot Key %@ is released";
tHotKeyTriggerDescTappedFormat= "The Hot Key %@ is tapped";
tHotKeyTriggerDescTappedOnceFormat= "The Hot Key %@ is tapped once";
tHotKeyTriggerDescTappedTwiceFormat= "The Hot Key %@ is tapped twice";
tHotKeyTriggerDescTappedTimesFormat= "The Hot Key %@ is tapped %d times";
tMIDITriggerDescPressedFormat= "The MIDI note %d is pressed";
tMIDITriggerDescWhileDownFormat= "While the MIDI note %d is down";
tMIDITriggerDescReleasedFormat= "The MIDI note %d is released";
tMIDITriggerShortDescFormat= "‚ô™%d";
tUSBTriggerAny= "Any USB Device is %%@";
tUSBTriggerNamed= "USB Device ‚Äò%@‚Äô is %%@";
tUSBTriggerContaining= "USB Device with Name Containing ‚Äò%@‚Äô is %%@";
tUSBTriggerMatching= "USB Device with Name Matching ‚Äò%@‚Äô is %%@";
tUSBTriggerAttached= "Attached";
tUSBTriggerDetached= "Detached";
tUSBTriggerShortDesc= "USB";
tVolumeTriggerAny= "Any Volume is %%@";
tVolumeTriggerNamed= "Volume ‚Äò%@‚Äô is %%@";
tVolumeTriggerContaining= "Volume with Name Containing ‚Äò%@‚Äô is %%@";
tVolumeTriggerMatching= "Volume with Name Matching ‚Äò%@‚Äô is %%@";
tVolumeTriggerShortDesc= "üíø";
tFolderTriggerAddImmediate= "Anything is added to folder ‚Äò%@‚Äô (immediately)";
tFolderTriggerAddIgnorePartial= "Anything is added to folder ‚Äò%@‚Äô (ignoring partial files)";
tFolderTriggerAddWaitCompletion= "Anything is added to folder ‚Äò%@‚Äô (ignoring partial or changing files)";
tFolderTriggerRemoveImmediate= "Anything is removed from folder ‚Äò%@‚Äô (immediately)";
tFolderTriggerRemoveIgnorePartial= "Anything is removed from folder ‚Äò%@‚Äô (ignoring partial files)";
tFolderTriggerBothImmediate= "Anything is added to or removed from folder ‚Äò%@‚Äô (immediately)";
tFolderTriggerBothIgnorePartial= "Anything is added to or removed from folder ‚Äò%@‚Äô (ignoring partial files)";
tFolderTriggerBothWaitCompletion= "Anything is added to or removed from folder ‚Äò%@‚Äô (ignoring partial or changing files)";
tFolderTriggerShortDesc= "üìÅ";
tWirelessNetworkTriggerAny= "Any Wireless Network is %%@";
tWirelessNetworkTriggerNameIs= "Wireless Network ‚Äò%@‚Äô is %%@";
tWirelessNetworkTriggerNameContains= "Wireless Network with Name Containing ‚Äò%@‚Äô is %%@";
tWirelessNetworkTriggerNameMatches= "Wireless Network with Name Matching ‚Äò%@‚Äô is %%@";
tWirelessNetworkTriggerBSSID= "Wireless Network with BSSID ‚Äò%@‚Äô is %%@";
tWirelessNetworkTriggerShortDesc= "‚úà";
tHIDTriggerShortDescFormat= "‚öÄ%@";
tTypeStringTriggerDescWithoutDeleteFormat= "The %@%@ ‚Äò%@‚Äô is typed (no deletes)";
tTypeStringTriggerDescWithDeleteFormat= "The %@%@ ‚Äò%@‚Äô is typed (then deleted)";
tTypeStringSpaceShort= "‚óá";
tTypeStringSpaceLong= "¬´Space¬ª";
tTypeStringTabShort= "‚á•";
tTypeStringTabLong= "¬´Tab¬ª";
tTypeStringReturnShort= "¬´Return¬ª";
tTypeStringReturnLong= "‚Ü©";
tTypeStringEnterShort= "¬´Enter¬ª";
tTypeStringEnterLong= "‚å§";
tTypeStringDiacriticalsMatterWordBreak= " (after a word break)";
tTypeStringDiacriticalsDontMatterAnywhere= " (ignoring diacriticals)";
tTypeStringDiacriticalsDontMatterWordBreak= " (after a word break, ignoring diacriticals)";
tTimeTrigger_DescFormat= "At %@ %@";
tTimeTrigger_TimeFormat= "%d:%02d";
tTimeTrigger_TimeBetweenFormat= "%d:%02d-%d:%02d";
tTimeTrigger_WhileLoggedInDescFormat= "Every %@ between %@ %@";
tTimeTrigger_EveryDay= "every day";
tTimeTrigger_Weekends= "weekends";
tTimeTrigger_NoDays= "No Days";
tTimeTrigger_WorkdaysAndWekendDays= "%@ and %@";
tTimeTrigger_CertainDaysFormat= "on %@";
tTimeTrigger_WeekdayRange= "%@-%@";
tTimeTrigger_RepeatingFormat= " repeating every %d %@";
tStatusMenuTrigger_LongDescription= "The Status Menu";
StatusMenuEmptyItem= "No Active Status Menu Triggers";
StatusMenuTriggerNoStatusMenu= "This macro will be listed in the status menu WHICH IS CURRENTLY DISABLED so this trigger will never fire.";
tPublicWebTrigger_LongDescription= "Via Public Web Access";
tPublicWebTrigger_ShortDescription= "Public Web";
tWakeTrigger_LongDescription= "At System Wake";
tWakeTrigger_ShortDescription= "Wake";
tSleepTrigger_LongDescription= "At System Sleep";
tSleepTrigger_ShortDescription= "Sleep";
tClipboardTrigger_LongDescription= "System Clipboard Changed";
TriggerByNameFormat= "Name Search for ‚Äò%@‚Äô";
TriggerByWebServer= "Web Server for ‚Äò%@‚Äô";
TriggerByURLScheme= "URL Scheme (kmtrigger) for ‚Äò%@‚Äô";
TriggerByCustomPrompt= "Custom HTML Prompt for ‚Äò%@‚Äô";
TriggerByMacroGroupPalette= "Macro Set Palette";
TriggerByDuplicateMacroPalette= "Duplicate Macro Palette";
TriggerByExecuteMacro= "Execute Macro";
TriggerByDoScript= "Do Script";
clRangeTitle= "Number Range Collection";
clRange_LongDescription= "The numbers from %@ to %@";
clRangeDown_LongDescription= "The numbers from %@ down to %@";
clApplicationsTitle= "Running Applications Collection";
clApplications_LongDescription= "The running applications";
clFilesTitle= "Folder Contents Collection";
clFiles_LongDescription= "The direct contents of folder ‚Äò%@‚Äô";
clFilesRecursive_LongDescription= "The recursive contents of folder ‚Äò%@‚Äô";
clFinderSelectionTitle= "Finder‚Äôs Selection Collection";
clFinderSelection_LongDescription= "The items in the Finder selection";
clFoundImagesTitle= "Found Images Collection";
clFoundImages_LongDescription= "The matching images found on the screen";
clVolumesTitle= "Mounted Volumes Collection";
clVolumes_LongDescription= "The mounted volumes";
clLinesInClipboardTitle= "Lines In Collection";
clLinesInClipboard_LongDescription= "The lines in the current clipboard";
clLinesInVariable_LongDescription= "The lines in variable ‚Äò%@‚Äô";
clLinesInFile_LongDescription= "The lines in file ‚Äò%@‚Äô";
clLinesInSystemClipboard_LongDescription= "The lines in system clipboard";
clLinesInNamedClipboard_LongDescription= "The lines in Named Clipboard ‚Äò%@‚Äô";
clSubstringsInTitle= "Substrings In Collection";
clSubstringsInVariable_LongDescription= "The substrings in variable ‚Äò%@‚Äô";
clSubstringsInFile_LongDescription= "The substrings in file ‚Äò%@‚Äô";
clSubstringsInSystemClipboard_LongDescription= "The substrings in system clipboard";
clSubstringsInNamedClipboard_LongDescription= "The substrings in Named Clipboard ‚Äò%@‚Äô";
clPastClipboardsTitle= "Clipboard History Collection";
clPastClipboards_LongDescription= "The past text clipboards";
cFrontWindow_LongDescription_Exists= "Front window exists";
cFrontWindow_LongDescription_DoesNotExist= "Front window does not exist";
cFrontWindow_LongDescription_TitleIs= "Front window title is ‚Äò%@‚Äô";
cFrontWindow_LongDescription_TitleIsNot= "Front window title is not ‚Äò%@‚Äô";
cFrontWindow_LongDescription_ExistsButTitleIsNot= "Front window exists but title is not ‚Äò%@‚Äô";
cFrontWindow_LongDescription_TitleContains= "Front window title contains ‚Äò%@‚Äô";
cFrontWindow_LongDescription_TitleDoesNotContain= "Front window title does not contain ‚Äò%@‚Äô";
cFrontWindow_LongDescription_ExistsButTitleDoesNotContain= "Front window exists but title does not contain ‚Äò%@‚Äô";
cFrontWindow_LongDescription_TitleMatches= "Front window title matches ‚Äò%@‚Äô";
cFrontWindow_LongDescription_TitleDoesNotMatch= "Front window title does not match ‚Äò%@‚Äô";
cFrontWindow_LongDescription_ExistsButTitleDoesNotMatch= "Front window exists but title does not match ‚Äò%@‚Äô";
cAnyWindowTitle= "Any Window Condition";
cAnyWindow_LongDescription_TitleIs= "Any window title is ‚Äò%@‚Äô";
cAnyWindow_LongDescription_TitleIsNot= "Any window title is not ‚Äò%@‚Äô";
cAnyWindow_LongDescription_TitleContains= "Any window title contains ‚Äò%@‚Äô";
cAnyWindow_LongDescription_TitleDoesNotContain= "Any window title does not contain ‚Äò%@‚Äô";
cAnyWindow_LongDescription_TitleMatches= "Any window title matches ‚Äò%@‚Äô";
cAnyWindow_LongDescription_TitleDoesNotMatch= "Any window title does not match ‚Äò%@‚Äô";
cButtonTitle= "Button Condition";
cButton_LongDescription_Exists= "Button %@ ‚Äò%@‚Äô exists";
cButton_LongDescription_DoesNotExist= "Button %@ ‚Äò%@‚Äô does not exist";
cButton_LongDescription_IsEnabled= "Button %@ ‚Äò%@‚Äô is enabled";
cButton_LongDescription_IsNotEnabled= "Button %@ ‚Äò%@‚Äô is not enabled";
cButton_LongDescription_ExistsButIsNotEnabled= "Button %@ ‚Äò%@‚Äô exists but is not enabled";
cButton_LongDescription_IsOff= "Button %@ ‚Äò%@‚Äô is off";
cButton_LongDescription_IsOn= "Button %@ ‚Äò%@‚Äô is on";
cButton_LongDescription_IsMixed= "Button %@ ‚Äò%@‚Äô is mixed";
cButtonSelection_Is= "with name";
cButtonSelection_Contains= "with name containing";
cButtonSelection_Matches= "with name matching";
cWirelessNetworkTitle= "Wireless Network Condition";
cWirelessNetwork_AnyConnected= "Any wireless network is connected";
cWirelessNetwork_AnyNotConnected= "No wireless network is connected";
cWirelessNetwork_OtherIsConnected= "A wireless network %@ is connected";
cWirelessNetwork_OtherIsNotConnected= "A wireless network %@ is not connected";
cWirelessNetworkSelection_NameIs= "with name ‚Äò%@‚Äô";
cWirelessNetworkSelection_NameContains= "with name containing ‚Äò%@‚Äô";
cWirelessNetworkSelection_NameMatches= "with name matching ‚Äò%@‚Äô";
cWirelessNetworkSelection_BSSID= "with BSSID ‚Äò%@‚Äô";
cUSBDeviceTitle= "USB Device Condition";
cUSBDevice_LongDescription_Exists= "USB device %@ ‚Äò%@‚Äô exists";
cUSBDevice_LongDescription_DoesNotExist= "USB device %@ ‚Äò%@‚Äô does not exist";
cMenuTitle= "Menu Condition";
cMenu_LongDescription_Exists= "Menu %@ ‚Äò%@‚Äô exists";
cMenu_LongDescription_DoesNotExist= "Menu %@ ‚Äò%@‚Äô does not exist";
cMenu_LongDescription_IsEnabled= "Menu %@ ‚Äò%@‚Äô is enabled";
cMenu_LongDescription_IsNotEnabled= "Menu %@ ‚Äò%@‚Äô is not enabled";
cMenu_LongDescription_ExistsButIsNotEnabled= "Menu %@ ‚Äò%@‚Äô exists but is not enabled";
cMenu_LongDescription_IsMarked= "Menu %@ ‚Äò%@‚Äô is marked";
cMenu_LongDescription_IsNotMarked= "Menu %@ ‚Äò%@‚Äô is not marked";
cMenu_LongDescription_ExistsButIsNotMarked= "Menu %@ ‚Äò%@‚Äô exists but is not marked";
cMenuSelection_Path= "with path";
cMenuSelection_Shortcut= "with shortcut";
cModifiers_LongDescription_Always = "The modifiers are in any state (always true)";
cModifiers_LongDescription_JustDown = "The modifiers %@ are down";
cModifiers_LongDescription_JustUp = "The modifiers %@ are up";
cModifiers_LongDescription_Both = "The modifiers %@ are down, and %@ are up";
cKeyTitle= "Key Condition";
cKey_LongDescription_Down= "The key %@ is down";
cKey_LongDescription_Up= "The key %@ is up";
cTypedStringTitle= "Typed String Condition";
cTypedString_LongDescriptionTitle= "The typed string was %@";
cTypedStringNone= "lowercase";
cTypedStringTitleCase= "title case";
cTypedStringUpperCase= "uppercase";
cDiskTitle= "Mounted Volume Condition";
cDisk_LongDescription_Exists= "Mounted Volume %@ ‚Äò%@‚Äô exists";
cDisk_LongDescription_DoesNotExist= "Mounted Volume %@ ‚Äò%@‚Äô does not exist";
cPathTitle= "Path Condition";
cPath_LongDescription_NothingExists= "Nothing exists at path ‚Äò%@‚Äô";
cPath_LongDescription_SomethingExists= "Something exists at path ‚Äò%@‚Äô";
cPath_LongDescription_FileExists= "A file exists at path ‚Äò%@‚Äô";
cPath_LongDescription_FileDoesNotExists= "A file does not exist at path ‚Äò%@‚Äô";
cPath_LongDescription_FolderExists= "A folder exists at path ‚Äò%@‚Äô";
cPath_LongDescription_FolderDoesNotExists= "A folder does not exist at path ‚Äò%@‚Äô";
cClipboardTitle= "Clipboard Condition";
cClipboard_LongDescription_HasText= "The clipboard has some text";
cClipboard_LongDescription_DoesNotHaveText= "The clipboard does not have any text";
cClipboard_LongDescription_HasImage= "The clipboard has an image";
cClipboard_LongDescription_DoesNotHaveImage= "The clipboard does not have an image";
cClipboard_LongDescription_Is= "The clipboard text is ‚Äò%@‚Äô";
cClipboard_LongDescription_IsNot= "The clipboard text is not ‚Äò%@‚Äô";
cClipboard_LongDescription_IsBefore= "The clipboard text is before ‚Äò%@‚Äô";
cClipboard_LongDescription_IsAfter= "The clipboard text is after ‚Äò%@‚Äô";
cClipboard_LongDescription_Contains= "The clipboard text contains ‚Äò%@‚Äô";
cClipboard_LongDescription_DoesNotContain= "The clipboard text does not contain ‚Äò%@‚Äô";
cClipboard_LongDescription_Matches= "The clipboard text matches ‚Äò%@‚Äô";
cClipboard_LongDescription_DoesNotMatch= "The clipboard text does not match ‚Äò%@‚Äô";
cClipboard_LongDescription_ConformsTo= "The clipboard text conforms to ‚Äò%@‚Äô";
cClipboard_LongDescription_DoesNotConformTo= "The clipboard text does not conform to ‚Äò%@‚Äô";
cVariable_LongDescription_Exists= "The variable ‚Äò%@‚Äô exists";
cVariable_LongDescription_DoesNotExist= "The variable ‚Äò%@‚Äô does not exist";
cVariable_LongDescription_IsEmpty= "The variable ‚Äò%@‚Äô is empty";
cVariable_LongDescription_IsNotEmpty= "The variable ‚Äò%@‚Äô is not empty";
cVariable_LongDescription_Is= "The variable ‚Äò%@‚Äô is ‚Äò%@‚Äô";
cVariable_LongDescription_IsNot= "The variable ‚Äò%@‚Äô is not ‚Äò%@‚Äô";
cVariable_LongDescription_IsBefore= "The variable ‚Äò%@‚Äô is before ‚Äò%@‚Äô";
cVariable_LongDescription_IsAfter= "The variable ‚Äò%@‚Äô is after ‚Äò%@‚Äô";
cVariable_LongDescription_Contains= "The variable ‚Äò%@‚Äô contains ‚Äò%@‚Äô";
cVariable_LongDescription_DoesNotContain= "The variable ‚Äò%@‚Äô does not contain ‚Äò%@‚Äô";
cVariable_LongDescription_Matches= "The variable ‚Äò%@‚Äô matches ‚Äò%@‚Äô";
cVariable_LongDescription_DoesNotMatch= "The variable ‚Äò%@‚Äô does not match ‚Äò%@‚Äô";
cText_LongDescription_IsEmpty= "The text ‚Äò%@‚Äô is empty";
cText_LongDescription_IsNotEmpty= "The text ‚Äò%@‚Äô is not empty";
cText_LongDescription_Is= "The text ‚Äò%@‚Äô is ‚Äò%@‚Äô";
cText_LongDescription_IsNot= "The text ‚Äò%@‚Äô is not ‚Äò%@‚Äô";
cText_LongDescription_IsBefore= "The text ‚Äò%@‚Äô is before ‚Äò%@‚Äô";
cText_LongDescription_IsAfter= "The text ‚Äò%@‚Äô is after ‚Äò%@‚Äô";
cText_LongDescription_Contains= "The text ‚Äò%@‚Äô contains ‚Äò%@‚Äô";
cText_LongDescription_DoesNotContain= "The text ‚Äò%@‚Äô does not contain ‚Äò%@‚Äô";
cText_LongDescription_Matches= "The text ‚Äò%@‚Äô matches ‚Äò%@‚Äô";
cText_LongDescription_DoesNotMatch= "The text ‚Äò%@‚Äô does not match ‚Äò%@‚Äô";
cCalculationTitle= "Calculation Condition";
cCalculation_LongDescription= "The calculation ‚Äò%@‚Äô returns true (non-zero)";
cMacroTitle= "Macro/Macro Group Condition";
cMacro_LongDescription= "The %@ is %@";
cEnvironmentVariable_LongDescription_IsBefore= "The environment variable ‚Äò%@‚Äô is before ‚Äò%@‚Äô";
cEnvironmentVariable_LongDescription_IsAfter= "The environment variable ‚Äò%@‚Äô is after ‚Äò%@‚Äô";
cPixel_LongDescription_Is= "The pixel at %@,%@ is";
cPixel_LongDescription_IsNot= "The pixel at %@,%@ is not";
cPixel_LongDescription_IsBrighter= "The pixel at %@,%@ is brighter than";
cPixel_LongDescription_IsDarker= "The pixel at %@,%@ is darker than";
cPixel_LongDescription_IsMoreRed= "The pixel at %@,%@ is more red";
cPixel_LongDescription_IsLessRed= "The pixel at %@,%@ is less red";
cPixel_LongDescription_IsMoreGreen= "The pixel at %@,%@ is more green";
cPixel_LongDescription_IsLessGreen= "The pixel at %@,%@ is less green";
cScript_LongDescription_IsBefore= "The script result is before ‚Äò%@‚Äô";
cScript_LongDescription_IsAfter= "The script result is after ‚Äò%@‚Äô";
MacroDoActionListFormat= "Execute macro ‚Äò%@‚Äô from trigger %@";
WebSeverPortError= "The HTTP port number must be between 1024 and 65534.";
WebServerPortDescription= "HTTPS port is one more (%d).";
WebServerBadPortDescription= "Must be 1024-65534.  Still using %d.";
WebServerStatusDisabledDescription= "Web server is disabled.  No remote access.";
WebServerStatusAuthention0Browser0iPhone0Clipboards0 = "Web server is enabled but all access is disabled.";
WebServerStatusAuthention0Browser0iPhone0Clipboards1 = "Web server is enabled for receiving clipboards only.";
WebServerStatusAuthention0Browser1iPhone0Clipboards0 = "Web server is enabled for Public triggers only.";
WebServerStatusAuthention0Browser1iPhone0Clipboards1 = "Web server is enabled for Public triggers and receiving clipboards.";
WebServerStatusAuthention1Browser0iPhone0Clipboards1 = "Web server is enabled for receiving clipboards only (username/password ignored).";
WebServerStatusAuthention1Browser0iPhone1Clipboards0 = "Web server is enabled for iOS access only.";
WebServerStatusAuthention1Browser0iPhone1Clipboards1 = "Web server is enabled for iOS access and receiving clipboards.";
WebServerStatusAuthention1Browser1iPhone0Clipboards0 = "Web server is enabled for public and authenticated browser access.";
WebServerStatusAuthention1Browser1iPhone0Clipboards1 = "Web server is enabled for public & authenticated access and receiving clipboards.";
WebServerStatusAuthention1Browser1iPhone1Clipboards0 = "Web server is enabled for public & authenticated access and iOS access.";
WebServerStatusAuthention1Browser1iPhone1Clipboards1 = "Web server is enabled for public & authenticated & iOS access and receiving clipboards.";
WebServerTriggerDisabledDescription= "Or via the web server but all remote access is disabled.";
WebServerTriggerAuthention0Browser1iPhone0Clipboards0 = "Or via the web server for Public Web triggered macros only.";
WebServerTriggerAuthention1Browser0iPhone1Clipboards0 = "Or via the web server for iOS access only.";
WebServerTriggerAuthention1Browser1iPhone0Clipboards0 = "Or via the web server for public and authenticated browser access.";
WebServerTriggerAuthention1Browser1iPhone1Clipboards0 = "Or via the web server for public, authenticated, and iOS access.";
TutorialOffRails1= "I am afraid you have deviated from the path of this tutorial.  Please try again.";
kInstallFailed= "Keyboard Maestro Install Failed, redirecting to download page";
kDownloadCorrupted= "Keyboard Maestro Download Failed, corrupted file, redirecting to download page";
kDownloadFailed= "Keyboard Maestro Download Failed, redirecting to download page";
FeedbackPostscript= "(I am running Keyboard Maestro %@ on Mac OS X %@ and have so far saved %@)";
MacroGroupNotDeleted_Title= "Macro Group Not Deleted";
MacroGroupNotDeleted_DescriptionWith0MacrosAnd0MacroGroups= "Nothing was deleted, and one or more Macro Groups were not deleted because they contained macros that were not selected.";
MacroGroupNotDeleted_DescriptionWith1MacrosAnd0MacroGroups= "One macro was deleted but one or more Macro Groups were not deleted because they contained macros that were not selected.";
MacroGroupNotDeleted_DescriptionWith2MacrosAnd0MacroGroups= "%1$d macros were deleted, but one or more Macro Groups were not deleted because they contained macros that were not selected.";
MacroGroupNotDeleted_DescriptionWith0MacrosAnd1MacroGroups= "A Macro Group was deleted, but one or more Macro Groups were not deleted because they contained macros that were not selected.";
MacroGroupNotDeleted_DescriptionWith1MacrosAnd1MacroGroups= "A Macro Group and a macro were deleted but one or more Macro Groups were not deleted because they contained macros that were not selected.";
MacroGroupNotDeleted_DescriptionWith2MacrosAnd1MacroGroups= "A Macro Group and %1$d macros were deleted, but one or more Macro Groups were not deleted because they contained macros that were not selected.";
MacroGroupNotDeleted_DescriptionWith0MacrosAnd2MacroGroups= "%2$d Macro Groups was deleted, but one or more Macro Groups were not deleted because they contained macros that were not selected.";
MacroGroupNotDeleted_DescriptionWith1MacrosAnd2MacroGroups= "%2$d Macro Groups and a macro were deleted but one or more Macro Groups were not deleted because they contained macros that were not selected.";
MacroGroupNotDeleted_DescriptionWith2MacrosAnd2MacroGroups= "%2$d Macro Groups and %1$d macros were deleted, but one or more Macro Groups were not deleted because they contained macros that were not selected.";
GlobalMacroGroupNotDeleted_Title= "Global Macro Group Not Deleted";
GlobalMacroGroupNotDeleted_DescriptionWith0MacrosAnd0MacroGroups= "Nothing was deleted, and the Global Macro Groups is not allowed to be deleted (you can change it to Inactive if you desire).";
GlobalMacroGroupNotDeleted_DescriptionWith1MacrosAnd0MacroGroups= "One macro was deleted but the Global Macro Groups is not allowed to be deleted (you can change it to Inactive if you desire).";
GlobalMacroGroupNotDeleted_DescriptionWith2MacrosAnd0MacroGroups= "%1$d macros were deleted, but the Global Macro Groups is not allowed to be deleted (you can change it to Inactive if you desire).";
GlobalMacroGroupNotDeleted_DescriptionWith0MacrosAnd1MacroGroups= "A Macro Group was deleted, but the Global Macro Groups is not allowed to be deleted (you can change it to Inactive if you desire).";
GlobalMacroGroupNotDeleted_DescriptionWith1MacrosAnd1MacroGroups= "A Macro Group and a macro were deleted but the Global Macro Groups is not allowed to be deleted (you can change it to Inactive if you desire).";
GlobalMacroGroupNotDeleted_DescriptionWith2MacrosAnd1MacroGroups= "A Macro Group and %1$d macros were deleted, but the Global Macro Groups is not allowed to be deleted (you can change it to Inactive if you desire).";
GlobalMacroGroupNotDeleted_DescriptionWith0MacrosAnd2MacroGroups= "%2$d Macro Groups was deleted, but the Global Macro Groups is not allowed to be deleted (you can change it to Inactive if you desire).";
GlobalMacroGroupNotDeleted_DescriptionWith1MacrosAnd2MacroGroups= "%2$d Macro Groups and a macro were deleted but the Global Macro Groups is not allowed to be deleted (you can change it to Inactive if you desire).";
GlobalMacroGroupNotDeleted_DescriptionWith2MacrosAnd2MacroGroups= "%2$d Macro Groups and %1$d macros were deleted, but the Global Macro Groups is not allowed to be deleted (you can change it to Inactive if you desire).";
kInsertFunction = "Math
DOW([time]):DOW - Current or Specified Day of the Week (Sunday=1)
NoPreferencePanesAvailable = "No Preference Panes Available";
NumberPadSubmenu = "Key Pad";
FunctionKeySubmenu = "Function Key";
TabUniCharLong= "Tab";
DeleteUniCharShort= "‚å´";
EscapeUniCharShort= "‚éã";
ClearUniCharShort= "‚åß";
DeleteRightUniCharShort= "‚å¶";
PageUpUniCharShort= "‚áû";
PageDownUniCharShort= "‚áü";
HelpUniCharShort= "?";
HomeUniCharShort= "‚ÜñÔ∏é";
EndUniCharShort= "‚ÜòÔ∏é";
LeftArrowUniCharShort= "‚Üê";
RightArrowUniCharShort= "‚Üí";
DownArrowUniCharShort= "‚Üì";
UpArrowUniCharShort= "‚Üë";
ISOSectionUniCharShort= "¬ß";
ISOSectionUniCharLong= "Section Sign";
JISYenUniCharShort= "¬•";
JISYenUniCharLong= "JIS Yen";
JISUnderscoreUniCharShort= "‚íø_";
JISUnderscoreUniCharLong= "JIS Underscore";
JISKeypadCommaUniCharShort= "‚íø‚äû,";
JISKeypadCommaUniCharLong= "JIS Key Pad ,";
JISKeypadCommaUniCharName= "JIS Key Pad Comma";
JISEisuUniCharShort= "Eisu";
JISEisuUniCharLong= "JIS Eisu";
JISKanaUniCharShort= "Kana";
JISKanaUniCharLong= "JIS Kana";
NumberPadFormatShort= "‚äû%@";
NumberPadFormatLong= "Key Pad %@";
WidthCharacter = "‚Üî";
HeightCharacter = "‚Üï";
DownToCenterArrowCharacter = "‚§ì";
kCheckLocalizedStrings= "GOOD";
MenuGlyph6F = "F1";
MenuGlyph70 = "F2";
MenuGlyph71 = "F3";
MenuGlyph72 = "F4";
MenuGlyph73 = "F5";
MenuGlyph74 = "F6";
MenuGlyph75 = "F7";
MenuGlyph76 = "F8";
MenuGlyph77 = "F9";
MenuGlyph78 = "F10";
MenuGlyph79 = "F11";
MenuGlyph7A = "F12";
MenuGlyph87 = "F13";
MenuGlyph88 = "F14";
MenuGlyph89 = "F15";
MenuGlyph8F = "F16";
MenuGlyph90 = "F17";
MenuGlyph91 = "F18";
MenuGlyph92 = "F19";
kmKeystrokeBadAlreadyUsedStr= "The keystroke you have pressed for this hot key conflicts with a hot key in macro ‚Äò%@‚Äô.";
SIVCDescription= "Keyboard Maestro %@ is now available (you have %@).  Would you like to download and install it now?";
InstallFailedStr= "An error occurred while trying to instal the Keyboard Maestro update, redirecting to the download page.";
MacroGroupFrontWindowCondition_ExistsButTitleIsNot= "Available when there is a focused window but its title is not ‚Äú%@‚Äù.";
MacroGroupFrontWindowCondition_TitleContains= "Available when the focused window title contains ‚Äú%@‚Äù.";
MacroGroupFrontWindowCondition_TitleDoesNotContain= "Available when the focused window title does not contain ‚Äú%@‚Äù.";
MacroGroupFrontWindowCondition_ExistsButTitleDoesNotContain= "Available when there is a focused window but its title does not contain ‚Äú%@‚Äù.";
MacroGroupFrontWindowCondition_TitleMatches= "Available when the focused window title matches ‚Äú%@‚Äù.";
MacroGroupFrontWindowCondition_TitleDoesNotMatch= "Available when the focused window title does not match ‚Äú%@‚Äù.";
MacroGroupFrontWindowCondition_ExistsButTitleDoesNotMatch= "Available when there is a focused window but its title does not match ‚Äú%@‚Äù.";
csDeleteClipDataWarningStr= "Are you sure you want to delete the selected clipboard position(s)?";
AskPermissionStr                        = "Keyboard Maestro Engine is Required for Macros to Function";
AskPermissionText                       = "Keyboard Maestro will launch the Keyboard Maestro Engine which is what actually executes your macros and it should continue running after you quit Keyboard Maestro so that your macros continue to operate.\r\rYou only need the Keyboard Maestro editor when you change your macros.\r\rYou can quit the engine at any time by selecting Quit Keyboard Maestro Engine from the Keyboard Maestro status menu.  You should also enable Launch Engine at Login in the preferences so the engine will always be available.\r\rWhat should happen to the engine when you quit the Keyboard Maestro editor?\r";
AskPermissionKeepRunningButton          = "Keep Running";
AskPermissionAlwaysKeepRunningButton    = "Always Keep Running";
WarnAccessibilityTitle= "Accessibility Access is Required";
WarnAccessibilityMessage= "Accessibility access to control your computer is required to use many features including selecting menu items, manipulating windows, pressing buttons, typed string triggers and the window switcher.  Please enable Accessibility for Keyboard Maestro and Keyboard Maestro Engine in the Accessibility section of the Privacy section of the Security & Privacy system preference pane.";
WarnAccessibilityDefaultButton= "Open Preferences";
WarnAccessibilityIgnoreButton= "Later";
WarnAccessibilityNotAgainButton= "Don‚Äôt Ask Again";
UniversalAccessWarningMessage= "Accessibility access to control your computer is required to use many features selecting menu items, manipulating windows, pressing buttons, typed string triggers and the window switcher.\r\rPlease enable Accessibility for Keyboard Maestro and Keyboard Maestro Engine in the Accessibility section of the Privacy section of the Security & Privacy system preference pane.";
UniversalAccessWarningDefaultButton= "Open System Preferences";
WarnKMSwitcherConflictText= "Keyboard Maestro Engine is running and has its own switchers enabled.  These may conflict with the switchers provided by Switcher Maestro, so you might want to disable them.";
WarnPrefWriteFailedText= "Keyboard Maestro failed to write the preferences file. %@ %@ You should quit and fix the problem and then relaunch Keyboard Maestro.";
SharingDisabledBecauseOfNewerWarningMessage= "Syncing macros has been disabled because the macro sync file is from a newer version of Keyboard Maestro.  Update this version of Keyboard Maestro to resume sharing, otherwise your local changes will be destroyed when you do update.";
SecureInputWarningMessageNoWho= "Secure Input is enabled which means the system thinks you are currently in a password field and will not allow applications to monitor the keyboard.\r\rThis will stop typed string triggers from working, as well as stop Keyboard Maestro from sensing your keystrokes while setting hot keys.\r\rYou will need to find the application responsible (often 1Password or LastPass or their Chrome extensions) and quit it.";
SecureInputWarningMessageWithWho= "Secure Input is enabled which means the system thinks you are currently in a password field and will not allow applications to monitor the keyboard.\r\rThis will stop typed string triggers from working, as well as stop Keyboard Maestro from sensing your keystrokes while setting hot keys.\r\rYou will need to find the application responsible (probably %@) and quit it.";
Early1010WarningTitle= "Early Version of Yosemite";
Early1010WarningMessage= "You are running an early version of OS X 10.10 Yosemite.  Versions of Yosemite prior to 10.10.3 had serious bugs in the accessibility preference setting system, making it very difficult to enable accessibility for both Keyboard Maestro and especially Keyboard Maestro Engine.  It is strongly recommended that you upgrade to 10.10.3 or later if at all possible.";
NamedClipboardDeleteWarningMessage= "One or more of the Named Clipboards you are trying to delete is currently in use by a macro.  You can delete it, but it will soon be recreated.";
VariableDeleteWarningMessage= "One or more of the Variables you are trying to delete is currently in use by a macro.  You can delete it, but it may soon be recreated.";
SharingOpenWarningMessage= "Syncing from an existing macro sync file will replace all of your existing macros with the macros from the remote file you select.";
SyncCreateMacrosSuccessMessage= "The macros have been written to the sync file, and will be written whenever the local macros are changed. Any change to the sync file will result in the local macros being replaced from that file.";
SyncOpenMacrosSuccessMessage= "The macros have been replaced with those from sync file, and the macros will be written whenever the local macros are changed. Any change to the sync file will result in the local macros being replaced from that file.";
ShareLibrary_Success_Description0= "The file was written, but no macros were saved.";
ShareLibrary_Success_Description1= "One macro was saved to a library.";
ShareLibrary_Success_Description2= "%d macros were saved to a library.";
ShareActionsOrMacrosFailedHeader= "Failed to export %@.";
ShareActionsOrMacrosFailedMessage= "The attempt to export the %@ failed, the %@ have not been exported.";
ExportMacrosFailedHeader= "Failed to export macros.";
ExportMacrosFailedMessage= "The attempt to export the macros failed, the macros have not been exported.";
ExportMacros_Success_Title= "Exported Macros";
ExportMacros_Success_Description0= "The file was written, but no macros were exported.";
ExportMacros_Success_Description1= "One macro was exported.";
ExportMacros_Success_Description2= "%d macros were exported.";
ExportActionsFailedHeader= "Failed to export actions.";
ExportActionsFailedMessage= "The attempt to export the actions failed, the actions have not been exported.";
ExportActions_Success_Title= "Exported Actions";
ExportActions_Success_Description0= "The file was written, but no actions were exported.";
ExportActions_Success_Description1= "One action was exported.";
ExportActions_Success_Description2= "%d actions were exported.";
ImportActions_Success_Title= "Imported Actions";
ImportActions_Success_Description0= "The file was written, but no actions were importeded.";
ImportActions_Success_Description1= "One action was importeded.";
ImportActions_Success_Description2= "%d actions were importeded.";
ImportActions_CantImportErrorTitle= "Cannot Import Actions File";
ImportActions_CantImportError_UnknownExplanation= "The Actions File you selected is of an unknown format.";
ImportMacros_CantImportErrorTitle= "Cannot Import Macro File";
ImportMacros_CantImportError_UnknownExplanation= "The Macro File you selected is of an unknown format.";
ImportMacros_Success_Title= "Imported Macros";
ImportLibrary_CantImportErrorTitle= "Cannot Import Library File";
ImportLibrary_CantImportError_UnknownExplanation= "The Library File you select is of an unknown format.";
ImportLibrary_Success_Title= "Inserted Library";
Import_Success_Description000= "The file was read, but no macros were imported.";
Import_Success_Description001= "One smart group imported.";
Import_Success_Description002= "%%d smart groups imported.";
Import_Success_Description110= "One macro was imported.";
Import_Success_Description111= "One macro and one smart group were imported.";
Import_Success_Description112= "One macro and %%d smart groups were imported.";
Import_Success_Description210= "%d macros were imported into one macro group.";
Import_Success_Description211= "%d macros were imported into one macro group and one smart group was imported.";
Import_Success_Description212= "%d macros were imported into one macro group and %%d smart groups were imported.";
Import_Success_Description220= "%d macros were imported into %d macro groups.";
Import_Success_Description221= "%d macros were imported into %d macro groups and one smart group was imported.";
Import_Success_Description222= "%d macros were imported into %d macro groups and %%d smart groups were imported.";
MacroGroupDefaultName_GlobalTarget= "Macros for All Applications";
MacroGroupDefaultName_SpecificApps= "Macros for ";
MacroGroupDefaultName_ExcludedApps= "Macros Not Active In ";
MacroGroupDefaultName_AppSeperator= ", ";
NagWindowTitle= "Keyboard Maestro %@";
InvalidSerialMessage= "Make sure you enter your email address and serial number exactly as they appear on your registration acknowledgment email.";
OldSerialMessage= "The username and serial number you have entered is valid for an older version, you will need to enter your new serial number.";
PSShowMenu= "Show (s)";
PSHideMenu= "Hide (h)";
PSLaunchMenu= "Launch (l)";
PSLaunchAndHideOthersMenu= "Launch & Hide Others (d)";
PSSwitchMenu= "Activate (l)";
PSSwitchAndHideOthersMenu= "Activate & Hide Others (d)";
ALLaunchMenu= "Launch";
ALLaunchAndHideOthersMenu= "Launch & Hide Others";
SIVCLanguage= "EN";
MacAppStoreVersion= "Mac App Store Version";
apmMore= "More‚Ä¶";
DefaultSearchTitle= "Search the web with Google";
DefaultSearchURL= "https://www.google.com/search?q=%Search%";
hkExecuteJavaScriptForCustomPrompt= "Execute a JavaScript in Custom Prompt";
hkExecuteJavaScriptForCustomPromptAll= "Execute a JavaScript in all Custom Prompts";
hkExecuteJavaScriptForCustomPromptTitle= "Execute a JavaScript in Custom Prompt with ID ‚Äò%@‚Äô";
hkSetClipboardToNamedClipboard= "Set Clipboard to Named Clipboard"; // depricated
hkSaveClipboardToNamedClipboard= "Save Clipboard to Named Clipboard"; // depricated
SelectMenuApplicationNotFound= "Select Menu Item failed to find target application for %@.";
SelectMenuApplicationNotFoundApp= "Select Menu Item failed to find target application ‚Äò%@‚Äô for %%@.";
SelectMenuBarNotFound= "Select Menu Item failed to find target menu bar for %@.";
SelectMenuItemNotFound= "Select Menu Item failed to find target menu item %@.";
SelectMenuItemDisabled= "Select Menu Item failed because the menu item %@ is disabled.";
SelectMenuItemFailed= "Menu selection failed to pick menu %@ with error %ld.";
SelectMenuItemRequiresAccess= "Select Menu Item action requires Accessibility which is disabled.";
PressButtonWindowNotFound= "Press Button ‚Äò%@‚Äô failed to find window.";
PressButtonButtonNotFound= "Press Button ‚Äò%@‚Äô failed to find button.";
PressButtonDisabled= "Press Button ‚Äò%@‚Äô failed because the button is disabled.";
PressButtonRequiresAccess= "Press Button action requires Accessibility which is disabled.";
MouseClickNoFrontWindow= "Move or Click Mouse no front window found.";
MouseClickNoImageFound= "Move or Click Mouse no unique image found.";
MouseClickNoImage= "Move or Click Mouse no image specified.";
MouseClickCalculateFailed= "Move or Click Mouse calculation %@ failed.";
TimeoutExceeded= "Action timeout exceeded.";
MacroCancelledFormat= "%@ Macro ‚Äò%@‚Äô cancelled (while executing %@).";
ActionFailedFormat= "%@ In macro ‚Äò%@‚Äô (while executing %@).";
kmModifierKeySeparator= "";
kmFKeyFormat= "F%d";
kmModifierControl= "Control";
kmModifierOption= "Option";
kmModifierShift= "Shift";
kmModifierCommand= "Command";
kmHiliteLocationTitleRectangle= "Highlight Rectangle at %@,%@,%@,%@";
kmHiliteLocationTitleOval= "Highlight Oval at %@,%@,%@,%@";
kmHiliteLocationTitleTarget= "Highlight Target at %@,%@,%@,%@";
kmExecuteAppleScriptType= "AppleScript";
kmExecuteJavaScriptType= "JavaScript in %@";
kmExecuteShellScriptType= "Shell Script";
kmExecuteJavaScriptForAutomationType= "JavaScript For Automation";
kmExecuteSwiftScriptType= "Swift Script";
//kmExecuteBaseScriptFileFormatResultsDescription= "The output of script ‚Äò%@‚Äô is:";
//kmExecuteBaseScriptTextScriptResultsDescription= "The output of the text script is:";
kmExecuteJavaScriptForCustomPromptResultsDescription= "The output of the script is:";
kmExecuteJavaScriptForCustomPromptResultsTitle= "JavaScript Results";
kMacroGroupToggleInternalAutomatic= "Internal Toggle Macro Group";
kMacroGroupToggleOnce= "Activate Macro Group for One Action";
kMacroGroupToggleActivate= "Activate Macro Group";
kMacroGroupToggleDeactivate= "Deactivate Macro Group";
kMacroGroupToggleToggle= "Activate/Deactivate Macro Group";
kMacroGroupToggleOnceWithPalette= "Show Macro Group for One Action";
kMacroGroupToggleShowPalette= "Show Macro Group";
kMacroGroupToggleHidePalette= "Hide Macro Group";
kMacroGroupToggleTogglePalette= "Show/Hide Macro Group";
kMacroGroupToggleInternalAutomaticFormat= "Internal Toggle Macro Group ‚Äò%@‚Äô";
kMacroGroupToggleOnceFormat= "Activate Macro Group ‚Äò%@‚Äô for One Action";
kMacroGroupToggleActivateFormat= "Activate Macro Group ‚Äò%@‚Äô";
kMacroGroupToggleDeactivateFormat= "Deactivate Macro Group ‚Äò%@‚Äô";
kMacroGroupToggleToggleFormat= "Activate/Deactivate Macro Group ‚Äò%@‚Äô";
kMacroGroupToggleOnceWithPaletteFormat= "Show Macro Group ‚Äò%@‚Äô for One Action";
kMacroGroupToggleShowPaletteFormat= "Show Macro Group ‚Äò%@‚Äô";
kMacroGroupToggleHidePaletteFormat= "Hide Macro Group ‚Äò%@‚Äô";
kMacroGroupToggleTogglePaletteFormat= "Show/Hide Macro Group ‚Äò%@‚Äô";
kmReadFileToClipboardTitleFormat= "Read File to Clipboard";
kmReadFileToNamedClipboardTitleFormat= "Read File to Named Clipboard ‚Äò%@‚Äô";
kmReadFileToVariableTitleFormat= "Read File to Variable ‚Äò%@‚Äô";
kmWriteFileFromClipboardTitleFormat= "%@ Clipboard";
kmWriteFileFromNamedClipboardTitleFormat= "%@ Named Clipboard ‚Äò%@‚Äô";
kmWriteFileFromVariableTitleFormat= "%@ Variable ‚Äò%@‚Äô";
kmWriteFileFromPlainTextTitleFormat= "%@ Text";
kmWriteFileFromStyledTextTitleFormat= "%@ Styled Text";
kmWriteFileMakeLongTitleFormat= "%@ to File";
kmActionTextSourceClipboard= "%@ of Clipboard";
kmActionTextSourceNamedClipboardFormat= "%@ of Named Clipboard ‚Äò%@‚Äô";
kmActionTextSourceVariableFormat= "%@ of Variable ‚Äò%@‚Äô";
kmActionTextSourceTextFormat= "%@ of Text ‚Äò%@‚Äô";
kmSubstringActionName= "Get Substring";
kmSwitchActionName= "Switch";
kmSubstringDestinationHTMLClipboard= "Store result to Clipboard";
kmSubstringDestinationHTMLNamedClipboardFormat= "Store result to Named Clipboard ‚Äò%@‚Äô";
kmSubstringDestinationHTMLVariableFormat= "Store result to Variable ‚Äò%@‚Äô";
kmCompositeImageClipboard= "Composite Clipboard onto Image";
kmCompositeImageText= "Composite Text onto Image";
kmCompositeImageHTMLClipboard= "Composite %@ onto Image in %@";
kmCompositeImageHTMLText= "Composite Text onto Image in %@";
kmNewFolderTitleLongFormat= "Create New Folder ‚Äò%@‚Äô";
kClipboardTargetNamedClipboardFormat= "Named Clipboard ‚Äò%@‚Äô";
kmApplyStyleHTMLDescriptionTitleFormat= "Apply Style to %@";
kmApplyTextFactoryHTMLDescriptionTitleFormat= "Apply Text Factory to %@";
kApplyStyleToTo= "Apply up to character %@";
kApplyStyleToFrom= "Apply from character %@";
kApplyStyleToLast= "Apply to last %@ characters";
kApplyStyleToRange= "Apply from character %@ length %@";
kApplyStyleToFromTo= "Apply from character %@ to character %@";
kSubstringRangeTo= "Subrange up to character %@";
kSubstringRangeFrom= "Subrange from character %@";
kSubstringRangeLast= "Subrange of last %@ characters";
kSubstringRangeRange= "Subrange from character %@ length %@";
kSubstringRangeFromTo= "Subrange from character %@ to character %@";
kSubstringRangeDeleteTo= "Subrange deleting up to character %@";
kSubstringRangeDeleteFrom= "Subrange deleting from character %@";
kSubstringRangeDeleteLast= "Subrange deleting last %@ characters";
kSubstringRangeDeleteRange= "Subrange deleting from character %@ length %@";
kSubstringRangeDeleteFromTo= "Subrange deleting from character %@ to character %@";
hkTrimImageHTMLTitle= "Trim Image in %@";
kmNewImageHTMLDescriptionTitleFormat= "Create New Image in %@";
kmDisplayImageFormat= "Display %@";
kmSetNetworkLocationFormat= "Set Network Location to ‚Äò%@‚Äô";
kmGetFileAttributeTitleFormat= "Get %@ to Variable ‚Äò%@‚Äô";
kmSetFileAttributeTitleFormat= "Set %@ to ‚Äò%@‚Äô";
kmOpen1FileTitleFormat= "Open ‚Äò%@‚Äô";
kmOpenPrefPaneTitleFormat= "Open %@ Preference Pane";
kmOpen1PasswordTitleFormat= "Open 1Password Bookmark %@‚Äô";
kmForTitle= "For Each Item in a Collection Execute Actions";
kmForHTMLTitle0= "For Each With No Collections Will Do Nothing";
kmForHTMLTitle1= "For Each Item in the Collection Execute Actions";
kmForHTMLTitle2= "For Each Item in these Collections Execute Actions";
kmSwitchIsDescription= "If it Is ‚Äú%@‚Äù";
kmSwitchIsNotDescription= "If it Is Not ‚Äú%@‚Äù";
kmSwitchContainsDescription= "If it Contains ‚Äú%@‚Äù";
kmSwitchDoesNotContainDescription= "If it Does Not Contain ‚Äú%@‚Äù";
kmSwitchMatchesDescription= "If it Matches ‚Äú%@‚Äù";
kmSwitchDoesNotMatchDescription= "If it Does Not Match ‚Äú%@‚Äù";
kmSwitchConformsToDescription= "If it Conforms To ‚Äú%@‚Äù";
kmSwitchDoesNotConformToDescription= "If it Does Not Conform To ‚Äú%@‚Äù";
hkDebuggerActionStepOverOthersTitle= "Debugger Step Over Other Macros";
hkDebuggerActionStepIntoOthersTitle= "Debugger Step Into Other Macros";
hkDebuggerActionStepOutOthersTitle= "Debugger Step Out Other Macros";
hkSpeakTextTitle= "Speak Text ‚Äò%@‚Äô";
hkSpeakTextVoiceTitle= "Speak Text With Voice ‚Äò%@‚Äô at %@ Rate";
hkSpeakTextDefaultVoiceTitle= "Speak Text With Default Voice ‚Äò%@‚Äô at %@ Rate";
hkSystemVolumeTitleFormat= "Set System Output Volume to %d%%";
hkSendMIDIMessageNoteOnTitleFormat= "Send MIDI channel %d note %d velocity %d";
hkSendMIDIMessageNoteOffTitleFormat= "Send MIDI channel %d note %d off";
hkSendMIDIMessageControlChangeTitleFormat= "Send MIDI channel %d control %d change to %d";
hkSendMIDIMessageNoteOnTitle= "Send MIDI Note On";
hkSendMIDIMessageNoteOffTitle= "Send MIDI Note Off";
hkSendMIDIMessageControlChangeTitle= "Send MIDI Control Change";
QuickTimePlayerCmd_StepForward_Title= "Step Forward Current Movie %@ Frames";
QuickTimePlayerCmd_StepForward_ShortTitle= "Step Forward Current Movie";
QuickTimePlayerCmd_StepBackward_Title= "Step Backward Current Movie %@ Frames";
QuickTimePlayerCmd_StepBackward_ShortTitle= "Step Backward Current Movie";
QuickTimePlayerCmd_IncreaseVolume_Title= "Increase Current Movie Volume by 10%";
QuickTimePlayerCmd_IncreaseVolume_ShortTitle= "Increase Current Movie Volume";
QuickTimePlayerCmd_DecreaseVolume_Title= "Decrease Current Movie Volume by 10%";
QuickTimePlayerCmd_DecreaseVolume_ShortTitle= "Decrease Current Movie Volume";
QuickTimePlayerCmd_SetVolume_TitleFormat= "Set Current Movie Volume to %d%%";
QuickTimePlayerCmd_SetVolume_Title= "Set Current Movie Volume";
aManipulateWindow_ResizeWindowByPercentFormat= "Scale %@ by Percent";
aManipulateWindow_ResizeWindowByFormat= "Resize %@ by Pixels";
aManipulateWindow_ResizeWindowToFormat= "Resize %@ to Pixels";
aManipulateWindow_MoveWindowByFormat= "Move %@ by Pixels";
aManipulateWindow_MoveWindowToFormat= "Move %@ to Position";
aManipulateWindow_MoveAndResizeFormat= "Move and Resize %@";
aManipulateWindow_CenterWindowFormat= "Center %@";
aManipulateWindow_CenterWindowAtFormat= "Center %@ at Position";
aManipulateWindow_CloseWindowFormat= "Close %@";
aManipulateWindow_ZoomWindowFormat= "Zoom %@";
aManipulateWindow_ReallyMinimizeWindowFormat= "Minimize %@";
aManipulateWindow_UnminimizeWindowFormat= "Unminimize %@";
aManipulateWindow_SelectWindowFormat= "Bring %@ to Front";
aManipulateWindow_FrontWindowName= "Front Window";
aManipulateWindow_NamedWindowFormat= "Window Named ‚Äò%@‚Äô";
aManipulateWindow_WindowWithNameContainingFormat = "Window(s) With Name Containing ‚Äò%@‚Äô";
aManipulateWindow_WindowWithIndexFormat= "Window With Index %@";
aManipulateWindow_New_SelectWindow= "Bring a Window to the Front";
kmScreenCaptureTitle= "Screen Capture %@";
kmScreenCaptureSourceScreenMain= "Screen Capture Main Screen";
kmScreenCaptureSourceScreenIndex= "Screen Capture Screen %@";
kmScreenCaptureSourceWindowFront= "Screen Capture Front Window";
kmScreenCaptureSourceWindowIndex= "Screen Capture Window %@";
kmScreenCaptureSourceWindowName= "Screen Capture Window ‚Äò%@‚Äô";
kmScreenCaptureSourceWindowNameContaining= "Screen Capture Window With Name Containing ‚Äò%@‚Äô";
kmScreenCaptureSourceWindowNameMatching= "Screen Capture Window With Name Matching ‚Äò%@‚Äô";
kHScreenAreaScreenIndexDescription= "Screen %@";
kHScreenAreaWindowNameDescription= "Window ‚Äò%@‚Äô";
kHScreenAreaWindowNameContainingDescription= "Window With Name Containing ‚Äò%@‚Äô";
kHScreenAreaWindowNameMatchingDescription= "Window With Name Matching ‚Äò%@‚Äô";
kHScreenAreaWindowIndexDescription= "Window %@";
kHScreenAreaAreaDescription= "Area (%@)";
kmDrawImageActionLine= "Draw a Line onto Image";
kmDrawImageActionRectangle= "Draw a Rectangle onto Image";
kmDrawImageActionOval= "Draw a Oval onto Image";
kmDrawImageActionHTML= "Draw onto Image in %@";
kmDrawImageLineHTML= "Draw a line from (%@,%@) to (%@,%@), %@ thick.";
kmDrawImageRectangleHTML= "Draw a rectangle from (%@,%@), %@ wide, %@ high, %@ thick.";
kmDrawImageOvalHTML= "Draw an oval centered (%@,%@), %@ wide, %@ high.";
kmTransformImageActionHTMLFlipHorizontal= "Flip Image in %@ Horizontally";
kmTransformImageActionHTMLFlipVertical= "Flip Image in %@ Vertically";
kmTransformImageActionHTMLRotateCW= "Rotate Image in %@ Clockwise";
kmTransformImageActionHTMLRotate180= "Rotate Image in %@ 180¬∞";
kmTransformImageActionHTMLRotateCCW= "Rotate Image in %@ Counter-Clockwise";
kmTransformImageActionHTMLFreeRotate= "Rotate Image in %@ by ‚Äò%@‚Äô";
kmGetImageSize= "Get Image %@ of %@";
kmResizeImageActionHTMLScaleTo= "Resize Image in %@";
kmResizeImageActionHTMLResizeTo= "Resize Canvas in %@";
kmResizeImageActionHTMLAddMargin= "Add or Remove Margins to Image in %@";
kmResizeImageActionHTMLCrop= "Crop Image in %@";
aSummaryReturnFormat= "%@‚Ü©";
aSummaryTextFormat= "%@‚Ä¶";
aInsertText_DisplayDescription= "The text is:";
aFastUserSwitch_DescriptionFormat= "Fast User Switch to ‚Äò%@‚Äô";
aSetKeyboardLayout_DescriptionFormat= "Set Keyboard Layout to ‚Äò%@‚Äô";
kmSimulateHardwareKeyPressAndReleaseTitleFormat= "Simulate the Hardware Key %@";
kmSimulateHardwareKeyPressAndHoldTitleFormat= "Press and Hold the Hardware Key %@";
kmSimulateHardwareKeyPressAndRepeatTitleFormat= "Press and Repeat the Hardware Key %@";
kmSimulateHardwareKeyReleaseTitleFormat= "Release the Hardware Key %@";
aSetClipboardToText_StyledText= "Styled Text";
aSetClipboardToText_DescriptionFormat= "Set %@ to %@";
aSetClipboardToText_DescriptionExtendedFormat= "%@ ‚Äò%@‚Äô";
aSetClipboardToText_DisplayDescription= "The clipboard would be:";
aSetVariableToText_DescriptionFormat= "Set Variable ‚Äò%@‚Äô to Text ‚Äò%@‚Äô";
aSetVariableToText_HTMLFormat= "Set Variable ‚Äò%@‚Äô to Text";
aSetVariableToSafariField_DescriptionFormat= "Set Variable ‚Äò%@‚Äô to %@ Field ‚Äò%@‚Äô";
aSetVariableToSafariField_NewActionFormat= "Set Variable to %@ Field";
aSetVariableToCalculation_DescriptionFormat= "Set Variable ‚Äò%@‚Äô To Calculation ‚Äò%@‚Äô";
aSetActionDelay00_DescriptionFormat= "Set %@ Delay for This Macro to %@ Seconds";
aSetActionDelay01_DescriptionFormat= "Set %@ Delay Globally to %@ Seconds";
aSetActionDelay10_DescriptionFormat= "Reset %@ Delay for This Macro to %@ Seconds";
aSetActionDelay11_DescriptionFormat= "Reset %@ Delay Globally to %@ Seconds";
aSetFindPasteboard_DescriptionFormat= "Set Find Pasteboard to Text ‚Äò%@‚Äô";
aSetVariableToKeychainPassword_DescriptionFormat= "Set Variable ‚Äò%@‚Äô to Keychain Password ‚Äò%@‚Äô";
aSetKeychainPasswordToText_DescriptionFormat= "Set Keychain Password ‚Äò%@‚Äô to Text ‚Äò%@‚Äô";
aSetSafariFieldToText_DescriptionFormat= "Set %@ Field ‚Äò%@‚Äô to Text";
aSetSafariFieldToText_NewActionFormat= "Set %@ Field to Text";
aSetSafariCheckbox_DescriptionCheckedFormat= "Set %@ Checkbox ‚Äò%@‚Äô to checked";
aSetSafariCheckbox_DescriptionUncheckedFormat= "Set %@ Checkbox ‚Äò%@‚Äô to unchecked";
aSetSafariCheckbox_DescriptionValueFormat= "Set %@ Checkbox ‚Äò%@‚Äô to ‚Äò%@‚Äô";
aSetSafariCheckbox_NewActionFormat= "Set %@ Checkbox";
aSetSafariRadio_DescriptionFormat= "Set %@ Radio Button ‚Äò%@‚Äô to ‚Äò%@‚Äô";
aSetSafariRadio_NewActionFormat= "Set %@ Radio Button";
kSetMailStatus_DescriptionOnFormat = "Set Mail %@ to On";
kSetMailStatus_DescriptionOffFormat = "Set Mail %@ to Off";
kSetMailStatus_DescriptionFormat = "Set Mail %@ to %@";
kMailFlagIndex= "Flag Index";
kMailFlagged= "Flagged Status";
kMailJunk= "Junk Status";
kMailRead= "Read Status";
kMailStatus0= "Off";
kMailStatus1= "On";
kMailFlagIndex0= "Unflagged";
kMailFlagIndex1= "Red";
kMailFlagIndex2= "Oragne";
aMailSendMessage_DescriptionFormat= "Send Mail Message with Subject ‚Äò%@‚Äô";
aExecuteJavaScript_NewActionFormat= "Execute a JavaScript in %@";
aPromptForUserInput_Format= "Prompt for User Input ‚Äò%@‚Äô";
hkFilterClipboardTitleFormat= "Filter %@ with %@";
hkFilterVariableTitleFormat= "Filter Variable ‚Äò%@‚Äô with %@";
kFilterRemoveStyles= "Remove Styles";
kFilterMacLineEndings= "Mac Line Endings";
kFilterUnixLineEndings= "Unix Line Endings";
kFilterWindowsLineEndings= "Windows Line Endings";
kFilterTrimWhitespace= "Trim Whitespace";
kFilterUnwrap= "Unwrap";
kFilterLowercase= "Lowercase";
kFilterLowercaseFirst= "Lowercase First";
kFilterUppercase= "Uppercase";
kFilterUppercaseFirst= "Uppercase First";
kFilterTitleCase= "Title Case";
kFilterDumbQuotes= "Dumb Quotes";
kFilterFrenchQuotes= "French Quotes";
kFilterSpaces= "Spaces";
kFilterTabs= "Tabs";
kFilterEncodeHTMLEntities= "Encode HTML Entities";
kFilterEncodeNonASCIIHTMLEntities= "Encode Non-ASCII HTML Entities";
kFilterDecodeHTMLEntities= "Decode HTML Entities";
kFilterMakeHTMLList= "HTML List";
kFilterPercentEncodeForURL= "Percent Encode for URL";
kFilterPercentDecodeURL= "Percent Decode URL";
kFilterQuoteForAppleScript= "Quote for AppleScript";
kFilterQuoteForJavaScript= "Quote for JavaScript";
kFilterQuoteForShellScript= "Quote for Shell Script";
kFilterQuoteForSwift= "Quote for Swift";
kFilterLastPathComponent= "Last Path Component";
kFilterDeleteLastPathComponent= "Delete Last Path Component";
kFilterPathExtension= "Path Extension";
kFilterDeletePathExtension= "Delete Path Extension";
kFilterExpandTildeInPath= "Expand Tilde In Path";
kFilterAbbreviateWithTildeInPath= "Abbreviate With Tilde In Path";
kFilterResolveSymlinks= "Resolve Symlinks";
kFilterStandardizePath= "Standardize Path";
kFilterZapControlCharacters= "Zap Control Characters";
kFilterBulletControlCharacters= "Bullet Control Characters";
kFilterCalculate= "Calculate";
kFilterProcessTokens= "Process Tokens";
kFilterValueOfNamedVariable= "Value of Named Variable";
kFilterValueOfNamedClipboard= "Value of Named Clipboard";
kFilterCharacterCount= "Character Count";
kFilterLineCount= "Line Count";
SearchReplaceClipboardActionType::kCaseSensitiveString= "Search and Replace %@ With String Matching (case sensitive)";
SearchReplaceClipboardActionType::kIgnoreCaseString= "Search and Replace %@ With String Matching (ignoring case)";
SearchReplaceClipboardActionType::kCaseSensitiveRegEx= "Search and Replace %@ Using Regular Expression (case sensitive)";
SearchReplaceClipboardActionType::kIgnoreCaseRegEx= "Search and Replace %@ Using Regular Expression (ignoring case)";
SearchReplaceVariableActionType::kCaseSensitiveString= "Search and Replace Variable ‚Äò%@‚Äô With String Matching (case sensitive)";
SearchReplaceVariableActionType::kIgnoreCaseString= "Search and Replace Variable ‚Äò%@‚Äô With String Matching (ignoring case)";
SearchReplaceVariableActionType::kCaseSensitiveRegEx= "Search and Replace Variable ‚Äò%@‚Äô Using Regular Expression (case sensitive)";
SearchReplaceVariableActionType::kIgnoreCaseRegEx= "Search and Replace Variable ‚Äò%@‚Äô Using Regular Expression (ignoring case)";
SearchVariableActionType::kCaseSensitiveRegEx= "Search Variable ‚Äò%@‚Äô Using Regular Expression (case sensitive)";
SearchVariableActionType::kIgnoreCaseRegEx= "Search Variable ‚Äò%@‚Äô Using Regular Expression (ignoring case)";
SearchClipboardActionType::kCaseSensitiveRegEx= "Search %@ Using Regular Expression (case sensitive)";
SearchClipboardActionType::kIgnoreCaseRegEx= "Search %@ Using Regular Expression (ignoring case)";
UseVariableActionType::kSetMouse= "Use Variable ‚Äò%@‚Äô to Set the Mouse Location";
UseVariableActionType::kSetWindowPosition= "Use Variable ‚Äò%@‚Äô to Set the Front Window Position";
UseVariableActionType::kSetWindowSize= "Use Variable ‚Äò%@‚Äô to Set the Front Window Size";
UseVariableActionType::kSetWindowFrame= "Use Variable ‚Äò%@‚Äô to Set the Front Window Frame";
UseVariableActionType::kSetWindowByName= "Use Variable ‚Äò%@‚Äô to Set the Front Window by Name";
UseVariableActionType::kSetWindowByNameContains= "Use Variable ‚Äò%@‚Äô to Set the Front Window by Name Contains";
UseVariableActionType::kSetWindowByNameMatches= "Use Variable ‚Äò%@‚Äô to Set the Front Window by Name Matching";
UseVariableActionType::kSetApplicationByName= "Use Variable ‚Äò%@‚Äô to Set the Front Application by Name";
UseVariableActionType::kSetApplicationByNameContains= "Use Variable ‚Äò%@‚Äô to Set the Front Application by Name Containing";
UseVariableActionType::kSetApplicationByNameMatches= "Use Variable ‚Äò%@‚Äô to Set the Front Application by Name Matching";
UseVariableActionType::kSetSystemVolume= "Use Variable ‚Äò%@‚Äô to Set the System Volume";
WriteFileFormatRTF= "RTF";
WriteFileFormatRTFD= "RTFD";
WriteFileFormatSimpleText= "Simple Text";
WriteFileFormatHTML= "HTML";
WriteFileFormatWebArchive= "Web Archive";
WriteFileFormatWordDoc= "Word Doc";
WriteFileFormatWordML= "Word ML";
WriteFileFormatOfficeOpenXML= "Office Open XML";
WriteFileFormatOpenDocument= "Open Document";
WriteFileFormatPNG= "PNG";
WriteFileFormatTIFF= "TIFF";
WriteFileFormatJPEG= "JPEG";
WriteFileFormatBMP= "BMP";
WriteFileFormatGIF= "GIF";
WriteFileEncodingMacRoman= "Mac Roman";
WriteFileEncodingLatin1= "ISO Latin 1";
WriteFileEncodingUTF8= "UTF8";
WriteFileEncodingUTF16= "UTF16";
aQuickMacro_DescriptionFormat= "Record Quick Macro for Hot Key %@";
aQuickMacro_TargetNameFormat= "%@ [Quick Macro]";
aMacroGroupToggle_TargetNameFormat= "%@ [Macro Group]";
aPressButton_DescriptionFormat= "Press Button ‚Äò%@‚Äô";
hkSemaphoreLock_DescriptionFormat= "Semaphore Lock ‚Äò%@‚Äô";
hkSemaphoreUnlock_DescriptionFormat= "Semaphore Unlock ‚Äò%@‚Äô";
hkSemaphoreReset_DescriptionFormat= "Semaphore Reset ‚Äò%@‚Äô";
SemaphoreUnlockFailed= "Semaphore Unlock ‚Äò%@‚Äô failed on unlocked semaphore";
aCSMacroAction_PasteFormat= "Paste from Named Clipboard ‚Äò%@‚Äô";
aCSMacroAction_CopyFormat= "Copy to Named Clipboard ‚Äò%@‚Äô";
aCSMacroAction_CutFormat= "Cut to Named Clipboard ‚Äò%@‚Äô";
aCSMacroAction_PasteTitle= "Paste from Named Clipboard";
aCSMacroAction_CopyTitle= "Copy to Named Clipboard";
aCSMacroAction_CutTitle= "Cut to Named Clipboard";
aSetClipboardToNamedClipboardFormat= "Set Clipboard to Named Clipboard ‚Äò%@‚Äô";
aSaveClipboardToNamedClipboardFormat= "Save Clipboard to Named Clipboard ‚Äò%@‚Äô";
aSetClipboardToPastClipboardFormat= "Set %@ to Past Clipboard %@";
aCopyClipboardNothing= "Copy Nothing";
aCopyClipboard= "Copy %@ to %@";
aDeletePastClipboardFormat= "Delete Past Clipboard %@";
UnitsIn1Second= "1 second";
UnitsInSeconds= "%d seconds";
UnitsIn1Minute= "1 minute";
UnitsInMinutes= "%d minutes";
UnitsIn1Hour= "1 hour";
UnitsInHours= "%d hours";
UnitsIn1Day= "1 day";
UnitsInDays= "%d days";
tUSBDeviceTriggerTitle= "USB Device Trigger";
tVolumeTriggerTitle= "Mounted Volume Trigger";
tFocusedWindowTriggerTitle= "Focused Window Trigger";
tFolderTriggerTitle= "Folder Trigger";
tHIDTriggerTitle= "Device Trigger";
tTypedStringTriggerTitle= "Typed String Trigger";
tApplicationTriggerTitle= "Application Trigger";
tTimeTriggerTitle= "Time of Day Trigger";
tWhileLoggedInTriggerTitle= "While Logged In Trigger";
tLoginTriggerTitle= "Login Trigger";
tLaunchTriggerTitle= "Launch Trigger";
tGlobalMacroPaletteTitle= "Global Macro Palette Trigger";
tStatusMenuTitle= "Status Menu Trigger";
tWakeTitle= "Wake Trigger";
tSleepTitle= "Sleep Trigger";
tClipboardTitle= "Clipboard Trigger";
tPublicWebTitle= "Public Web Trigger";
tScriptTitle= "Script Trigger";
tWirelessNetworkTriggerTitle= "Wireless Network Trigger";
tHotKeyTriggerDescPressedFormat= "The Hot Key %@ is pressed";
tHotKeyTriggerDescWhileDownFormat= "While the Hot Key %@ is down";
tHotKeyTriggerDescReleasedFormat= "The Hot Key %@ is released";
tHotKeyTriggerDescTappedFormat= "The Hot Key %@ is tapped";
tHotKeyTriggerDescTappedOnceFormat= "The Hot Key %@ is tapped once";
tHotKeyTriggerDescTappedTwiceFormat= "The Hot Key %@ is tapped twice";
tHotKeyTriggerDescTappedTimesFormat= "The Hot Key %@ is tapped %d times";
tMIDITriggerDescPressedFormat= "The MIDI note %d is pressed";
tMIDITriggerDescWhileDownFormat= "While the MIDI note %d is down";
tMIDITriggerDescReleasedFormat= "The MIDI note %d is released";
tMIDITriggerShortDescFormat= "‚ô™%d";
tUSBTriggerAny= "Any USB Device is %%@";
tUSBTriggerNamed= "USB Device ‚Äò%@‚Äô is %%@";
tUSBTriggerContaining= "USB Device with Name Containing ‚Äò%@‚Äô is %%@";
tUSBTriggerMatching= "USB Device with Name Matching ‚Äò%@‚Äô is %%@";
tUSBTriggerAttached= "Attached";
tUSBTriggerDetached= "Detached";
tUSBTriggerShortDesc= "USB";
tVolumeTriggerAny= "Any Volume is %%@";
tVolumeTriggerNamed= "Volume ‚Äò%@‚Äô is %%@";
tVolumeTriggerContaining= "Volume with Name Containing ‚Äò%@‚Äô is %%@";
tVolumeTriggerMatching= "Volume with Name Matching ‚Äò%@‚Äô is %%@";
tVolumeTriggerShortDesc= "üíø";
tFolderTriggerAddImmediate= "Anything is added to folder ‚Äò%@‚Äô (immediately)";
tFolderTriggerAddIgnorePartial= "Anything is added to folder ‚Äò%@‚Äô (ignoring partial files)";
tFolderTriggerAddWaitCompletion= "Anything is added to folder ‚Äò%@‚Äô (ignoring partial or changing files)";
tFolderTriggerRemoveImmediate= "Anything is removed from folder ‚Äò%@‚Äô (immediately)";
tFolderTriggerRemoveIgnorePartial= "Anything is removed from folder ‚Äò%@‚Äô (ignoring partial files)";
tFolderTriggerBothImmediate= "Anything is added to or removed from folder ‚Äò%@‚Äô (immediately)";
tFolderTriggerBothIgnorePartial= "Anything is added to or removed from folder ‚Äò%@‚Äô (ignoring partial files)";
tFolderTriggerBothWaitCompletion= "Anything is added to or removed from folder ‚Äò%@‚Äô (ignoring partial or changing files)";
tFolderTriggerShortDesc= "üìÅ";
tWirelessNetworkTriggerAny= "Any Wireless Network is %%@";
tWirelessNetworkTriggerNameIs= "Wireless Network ‚Äò%@‚Äô is %%@";
tWirelessNetworkTriggerNameContains= "Wireless Network with Name Containing ‚Äò%@‚Äô is %%@";
tWirelessNetworkTriggerNameMatches= "Wireless Network with Name Matching ‚Äò%@‚Äô is %%@";
tWirelessNetworkTriggerBSSID= "Wireless Network with BSSID ‚Äò%@‚Äô is %%@";
tWirelessNetworkTriggerShortDesc= "‚úà";
tHIDTriggerShortDescFormat= "‚öÄ%@";
tTypeStringTriggerDescWithoutDeleteFormat= "The %@%@ ‚Äò%@‚Äô is typed (no deletes)";
tTypeStringTriggerDescWithDeleteFormat= "The %@%@ ‚Äò%@‚Äô is typed (then deleted)";
tTypeStringSpaceShort= "‚óá";
tTypeStringSpaceLong= "¬´Space¬ª";
tTypeStringTabShort= "‚á•";
tTypeStringTabLong= "¬´Tab¬ª";
tTypeStringReturnShort= "¬´Return¬ª";
tTypeStringReturnLong= "‚Ü©";
tTypeStringEnterShort= "¬´Enter¬ª";
tTypeStringEnterLong= "‚å§";
tTypeStringDiacriticalsMatterWordBreak= " (after a word break)";
tTypeStringDiacriticalsDontMatterAnywhere= " (ignoring diacriticals)";
tTypeStringDiacriticalsDontMatterWordBreak= " (after a word break, ignoring diacriticals)";
tTimeTrigger_DescFormat= "At %@ %@";
tTimeTrigger_TimeFormat= "%d:%02d";
tTimeTrigger_TimeBetweenFormat= "%d:%02d-%d:%02d";
tTimeTrigger_WhileLoggedInDescFormat= "Every %@ between %@ %@";
tTimeTrigger_EveryDay= "every day";
tTimeTrigger_Weekends= "weekends";
tTimeTrigger_NoDays= "No Days";
tTimeTrigger_WorkdaysAndWekendDays= "%@ and %@";
tTimeTrigger_CertainDaysFormat= "on %@";
tTimeTrigger_WeekdayRange= "%@-%@";
tTimeTrigger_RepeatingFormat= " repeating every %d %@";
tStatusMenuTrigger_LongDescription= "The Status Menu";
StatusMenuEmptyItem= "No Active Status Menu Triggers";
StatusMenuTriggerNoStatusMenu= "This macro will be listed in the status menu WHICH IS CURRENTLY DISABLED so this trigger will never fire.";
tPublicWebTrigger_LongDescription= "Via Public Web Access";
tPublicWebTrigger_ShortDescription= "Public Web";
tWakeTrigger_LongDescription= "At System Wake";
tWakeTrigger_ShortDescription= "Wake";
tSleepTrigger_LongDescription= "At System Sleep";
tSleepTrigger_ShortDescription= "Sleep";
tClipboardTrigger_LongDescription= "System Clipboard Changed";
TriggerByNameFormat= "Name Search for ‚Äò%@‚Äô";
TriggerByWebServer= "Web Server for ‚Äò%@‚Äô";
TriggerByURLScheme= "URL Scheme (kmtrigger) for ‚Äò%@‚Äô";
TriggerByCustomPrompt= "Custom HTML Prompt for ‚Äò%@‚Äô";
TriggerByMacroGroupPalette= "Macro Set Palette";
TriggerByDuplicateMacroPalette= "Duplicate Macro Palette";
TriggerByExecuteMacro= "Execute Macro";
TriggerByDoScript= "Do Script";
clRangeTitle= "Number Range Collection";
clRange_LongDescription= "The numbers from %@ to %@";
clRangeDown_LongDescription= "The numbers from %@ down to %@";
clApplicationsTitle= "Running Applications Collection";
clApplications_LongDescription= "The running applications";
clFilesTitle= "Folder Contents Collection";
clFiles_LongDescription= "The direct contents of folder ‚Äò%@‚Äô";
clFilesRecursive_LongDescription= "The recursive contents of folder ‚Äò%@‚Äô";
clFinderSelectionTitle= "Finder‚Äôs Selection Collection";
clFinderSelection_LongDescription= "The items in the Finder selection";
clFoundImagesTitle= "Found Images Collection";
clFoundImages_LongDescription= "The matching images found on the screen";
clVolumesTitle= "Mounted Volumes Collection";
clVolumes_LongDescription= "The mounted volumes";
clLinesInClipboardTitle= "Lines In Collection";
clLinesInClipboard_LongDescription= "The lines in the current clipboard";
clLinesInVariable_LongDescription= "The lines in variable ‚Äò%@‚Äô";
clLinesInFile_LongDescription= "The lines in file ‚Äò%@‚Äô";
clLinesInSystemClipboard_LongDescription= "The lines in system clipboard";
clLinesInNamedClipboard_LongDescription= "The lines in Named Clipboard ‚Äò%@‚Äô";
clSubstringsInTitle= "Substrings In Collection";
clSubstringsInVariable_LongDescription= "The substrings in variable ‚Äò%@‚Äô";
clSubstringsInFile_LongDescription= "The substrings in file ‚Äò%@‚Äô";
clSubstringsInSystemClipboard_LongDescription= "The substrings in system clipboard";
clSubstringsInNamedClipboard_LongDescription= "The substrings in Named Clipboard ‚Äò%@‚Äô";
clPastClipboardsTitle= "Clipboard History Collection";
clPastClipboards_LongDescription= "The past text clipboards";
cFrontWindow_LongDescription_Exists= "Front window exists";
cFrontWindow_LongDescription_DoesNotExist= "Front window does not exist";
cFrontWindow_LongDescription_TitleIs= "Front window title is ‚Äò%@‚Äô";
cFrontWindow_LongDescription_TitleIsNot= "Front window title is not ‚Äò%@‚Äô";
cFrontWindow_LongDescription_ExistsButTitleIsNot= "Front window exists but title is not ‚Äò%@‚Äô";
cFrontWindow_LongDescription_TitleContains= "Front window title contains ‚Äò%@‚Äô";
cFrontWindow_LongDescription_TitleDoesNotContain= "Front window title does not contain ‚Äò%@‚Äô";
cFrontWindow_LongDescription_ExistsButTitleDoesNotContain= "Front window exists but title does not contain ‚Äò%@‚Äô";
cFrontWindow_LongDescription_TitleMatches= "Front window title matches ‚Äò%@‚Äô";
cFrontWindow_LongDescription_TitleDoesNotMatch= "Front window title does not match ‚Äò%@‚Äô";
cFrontWindow_LongDescription_ExistsButTitleDoesNotMatch= "Front window exists but title does not match ‚Äò%@‚Äô";
cAnyWindowTitle= "Any Window Condition";
cAnyWindow_LongDescription_TitleIs= "Any window title is ‚Äò%@‚Äô";
cAnyWindow_LongDescription_TitleIsNot= "Any window title is not ‚Äò%@‚Äô";
cAnyWindow_LongDescription_TitleContains= "Any window title contains ‚Äò%@‚Äô";
cAnyWindow_LongDescription_TitleDoesNotContain= "Any window title does not contain ‚Äò%@‚Äô";
cAnyWindow_LongDescription_TitleMatches= "Any window title matches ‚Äò%@‚Äô";
cAnyWindow_LongDescription_TitleDoesNotMatch= "Any window title does not match ‚Äò%@‚Äô";
cButtonTitle= "Button Condition";
cButton_LongDescription_Exists= "Button %@ ‚Äò%@‚Äô exists";
cButton_LongDescription_DoesNotExist= "Button %@ ‚Äò%@‚Äô does not exist";
cButton_LongDescription_IsEnabled= "Button %@ ‚Äò%@‚Äô is enabled";
cButton_LongDescription_IsNotEnabled= "Button %@ ‚Äò%@‚Äô is not enabled";
cButton_LongDescription_ExistsButIsNotEnabled= "Button %@ ‚Äò%@‚Äô exists but is not enabled";
cButton_LongDescription_IsOff= "Button %@ ‚Äò%@‚Äô is off";
cButton_LongDescription_IsOn= "Button %@ ‚Äò%@‚Äô is on";
cButton_LongDescription_IsMixed= "Button %@ ‚Äò%@‚Äô is mixed";
cButtonSelection_Is= "with name";
cButtonSelection_Contains= "with name containing";
cButtonSelection_Matches= "with name matching";
cWirelessNetworkTitle= "Wireless Network Condition";
cWirelessNetwork_AnyConnected= "Any wireless network is connected";
cWirelessNetwork_AnyNotConnected= "No wireless network is connected";
cWirelessNetwork_OtherIsConnected= "A wireless network %@ is connected";
cWirelessNetwork_OtherIsNotConnected= "A wireless network %@ is not connected";
cWirelessNetworkSelection_NameIs= "with name ‚Äò%@‚Äô";
cWirelessNetworkSelection_NameContains= "with name containing ‚Äò%@‚Äô";
cWirelessNetworkSelection_NameMatches= "with name matching ‚Äò%@‚Äô";
cWirelessNetworkSelection_BSSID= "with BSSID ‚Äò%@‚Äô";
cUSBDeviceTitle= "USB Device Condition";
cUSBDevice_LongDescription_Exists= "USB device %@ ‚Äò%@‚Äô exists";
cUSBDevice_LongDescription_DoesNotExist= "USB device %@ ‚Äò%@‚Äô does not exist";
cMenuTitle= "Menu Condition";
cMenu_LongDescription_Exists= "Menu %@ ‚Äò%@‚Äô exists";
cMenu_LongDescription_DoesNotExist= "Menu %@ ‚Äò%@‚Äô does not exist";
cMenu_LongDescription_IsEnabled= "Menu %@ ‚Äò%@‚Äô is enabled";
cMenu_LongDescription_IsNotEnabled= "Menu %@ ‚Äò%@‚Äô is not enabled";
cMenu_LongDescription_ExistsButIsNotEnabled= "Menu %@ ‚Äò%@‚Äô exists but is not enabled";
cMenu_LongDescription_IsMarked= "Menu %@ ‚Äò%@‚Äô is marked";
cMenu_LongDescription_IsNotMarked= "Menu %@ ‚Äò%@‚Äô is not marked";
cMenu_LongDescription_ExistsButIsNotMarked= "Menu %@ ‚Äò%@‚Äô exists but is not marked";
cMenuSelection_Path= "with path";
cMenuSelection_Shortcut= "with shortcut";
cModifiers_LongDescription_Always = "The modifiers are in any state (always true)";
cModifiers_LongDescription_JustDown = "The modifiers %@ are down";
cModifiers_LongDescription_JustUp = "The modifiers %@ are up";
cModifiers_LongDescription_Both = "The modifiers %@ are down, and %@ are up";
cKeyTitle= "Key Condition";
cKey_LongDescription_Down= "The key %@ is down";
cKey_LongDescription_Up= "The key %@ is up";
cTypedStringTitle= "Typed String Condition";
cTypedString_LongDescriptionTitle= "The typed string was %@";
cTypedStringNone= "lowercase";
cTypedStringTitleCase= "title case";
cTypedStringUpperCase= "uppercase";
cDiskTitle= "Mounted Volume Condition";
cDisk_LongDescription_Exists= "Mounted Volume %@ ‚Äò%@‚Äô exists";
cDisk_LongDescription_DoesNotExist= "Mounted Volume %@ ‚Äò%@‚Äô does not exist";
cPathTitle= "Path Condition";
cPath_LongDescription_NothingExists= "Nothing exists at path ‚Äò%@‚Äô";
cPath_LongDescription_SomethingExists= "Something exists at path ‚Äò%@‚Äô";
cPath_LongDescription_FileExists= "A file exists at path ‚Äò%@‚Äô";
cPath_LongDescription_FileDoesNotExists= "A file does not exist at path ‚Äò%@‚Äô";
cPath_LongDescription_FolderExists= "A folder exists at path ‚Äò%@‚Äô";
cPath_LongDescription_FolderDoesNotExists= "A folder does not exist at path ‚Äò%@‚Äô";
cClipboardTitle= "Clipboard Condition";
cClipboard_LongDescription_HasText= "The clipboard has some text";
cClipboard_LongDescription_DoesNotHaveText= "The clipboard does not have any text";
cClipboard_LongDescription_HasImage= "The clipboard has an image";
cClipboard_LongDescription_DoesNotHaveImage= "The clipboard does not have an image";
cClipboard_LongDescription_Is= "The clipboard text is ‚Äò%@‚Äô";
cClipboard_LongDescription_IsNot= "The clipboard text is not ‚Äò%@‚Äô";
cClipboard_LongDescription_IsBefore= "The clipboard text is before ‚Äò%@‚Äô";
cClipboard_LongDescription_IsAfter= "The clipboard text is after ‚Äò%@‚Äô";
cClipboard_LongDescription_Contains= "The clipboard text contains ‚Äò%@‚Äô";
cClipboard_LongDescription_DoesNotContain= "The clipboard text does not contain ‚Äò%@‚Äô";
cClipboard_LongDescription_Matches= "The clipboard text matches ‚Äò%@‚Äô";
cClipboard_LongDescription_DoesNotMatch= "The clipboard text does not match ‚Äò%@‚Äô";
cClipboard_LongDescription_ConformsTo= "The clipboard text conforms to ‚Äò%@‚Äô";
cClipboard_LongDescription_DoesNotConformTo= "The clipboard text does not conform to ‚Äò%@‚Äô";
cVariable_LongDescription_Exists= "The variable ‚Äò%@‚Äô exists";
cVariable_LongDescription_DoesNotExist= "The variable ‚Äò%@‚Äô does not exist";
cVariable_LongDescription_IsEmpty= "The variable ‚Äò%@‚Äô is empty";
cVariable_LongDescription_IsNotEmpty= "The variable ‚Äò%@‚Äô is not empty";
cVariable_LongDescription_Is= "The variable ‚Äò%@‚Äô is ‚Äò%@‚Äô";
cVariable_LongDescription_IsNot= "The variable ‚Äò%@‚Äô is not ‚Äò%@‚Äô";
cVariable_LongDescription_IsBefore= "The variable ‚Äò%@‚Äô is before ‚Äò%@‚Äô";
cVariable_LongDescription_IsAfter= "The variable ‚Äò%@‚Äô is after ‚Äò%@‚Äô";
cVariable_LongDescription_Contains= "The variable ‚Äò%@‚Äô contains ‚Äò%@‚Äô";
cVariable_LongDescription_DoesNotContain= "The variable ‚Äò%@‚Äô does not contain ‚Äò%@‚Äô";
cVariable_LongDescription_Matches= "The variable ‚Äò%@‚Äô matches ‚Äò%@‚Äô";
cVariable_LongDescription_DoesNotMatch= "The variable ‚Äò%@‚Äô does not match ‚Äò%@‚Äô";
cText_LongDescription_IsEmpty= "The text ‚Äò%@‚Äô is empty";
cText_LongDescription_IsNotEmpty= "The text ‚Äò%@‚Äô is not empty";
cText_LongDescription_Is= "The text ‚Äò%@‚Äô is ‚Äò%@‚Äô";
cText_LongDescription_IsNot= "The text ‚Äò%@‚Äô is not ‚Äò%@‚Äô";
cText_LongDescription_IsBefore= "The text ‚Äò%@‚Äô is before ‚Äò%@‚Äô";
cText_LongDescription_IsAfter= "The text ‚Äò%@‚Äô is after ‚Äò%@‚Äô";
cText_LongDescription_Contains= "The text ‚Äò%@‚Äô contains ‚Äò%@‚Äô";
cText_LongDescription_DoesNotContain= "The text ‚Äò%@‚Äô does not contain ‚Äò%@‚Äô";
cText_LongDescription_Matches= "The text ‚Äò%@‚Äô matches ‚Äò%@‚Äô";
cText_LongDescription_DoesNotMatch= "The text ‚Äò%@‚Äô does not match ‚Äò%@‚Äô";
cCalculationTitle= "Calculation Condition";
cCalculation_LongDescription= "The calculation ‚Äò%@‚Äô returns true (non-zero)";
cMacroTitle= "Macro/Macro Group Condition";
cMacro_LongDescription= "The %@ is %@";
cEnvironmentVariable_LongDescription_IsBefore= "The environment variable ‚Äò%@‚Äô is before ‚Äò%@‚Äô";
cEnvironmentVariable_LongDescription_IsAfter= "The environment variable ‚Äò%@‚Äô is after ‚Äò%@‚Äô";
cPixel_LongDescription_Is= "The pixel at %@,%@ is";
cPixel_LongDescription_IsNot= "The pixel at %@,%@ is not";
cPixel_LongDescription_IsBrighter= "The pixel at %@,%@ is brighter than";
cPixel_LongDescription_IsDarker= "The pixel at %@,%@ is darker than";
cPixel_LongDescription_IsMoreRed= "The pixel at %@,%@ is more red";
cPixel_LongDescription_IsLessRed= "The pixel at %@,%@ is less red";
cPixel_LongDescription_IsMoreGreen= "The pixel at %@,%@ is more green";
cPixel_LongDescription_IsLessGreen= "The pixel at %@,%@ is less green";
cScript_LongDescription_IsBefore= "The script result is before ‚Äò%@‚Äô";
cScript_LongDescription_IsAfter= "The script result is after ‚Äò%@‚Äô";
MacroDoActionListFormat= "Execute macro ‚Äò%@‚Äô from trigger %@";
WebSeverPortError= "The HTTP port number must be between 1024 and 65534.";
WebServerPortDescription= "HTTPS port is one more (%d).";
WebServerBadPortDescription= "Must be 1024-65534.  Still using %d.";
WebServerStatusDisabledDescription= "Web server is disabled.  No remote access.";
WebServerStatusAuthention0Browser0iPhone0Clipboards0 = "Web server is enabled but all access is disabled.";
WebServerStatusAuthention0Browser0iPhone0Clipboards1 = "Web server is enabled for receiving clipboards only.";
WebServerStatusAuthention0Browser1iPhone0Clipboards0 = "Web server is enabled for Public triggers only.";
WebServerStatusAuthention0Browser1iPhone0Clipboards1 = "Web server is enabled for Public triggers and receiving clipboards.";
WebServerStatusAuthention1Browser0iPhone0Clipboards1 = "Web server is enabled for receiving clipboards only (username/password ignored).";
WebServerStatusAuthention1Browser0iPhone1Clipboards0 = "Web server is enabled for iOS access only.";
WebServerStatusAuthention1Browser0iPhone1Clipboards1 = "Web server is enabled for iOS access and receiving clipboards.";
WebServerStatusAuthention1Browser1iPhone0Clipboards0 = "Web server is enabled for public and authenticated browser access.";
WebServerStatusAuthention1Browser1iPhone0Clipboards1 = "Web server is enabled for public & authenticated access and receiving clipboards.";
WebServerStatusAuthention1Browser1iPhone1Clipboards0 = "Web server is enabled for public & authenticated access and iOS access.";
WebServerStatusAuthention1Browser1iPhone1Clipboards1 = "Web server is enabled for public & authenticated & iOS access and receiving clipboards.";
WebServerTriggerDisabledDescription= "Or via the web server but all remote access is disabled.";
WebServerTriggerAuthention0Browser1iPhone0Clipboards0 = "Or via the web server for Public Web triggered macros only.";
WebServerTriggerAuthention1Browser0iPhone1Clipboards0 = "Or via the web server for iOS access only.";
WebServerTriggerAuthention1Browser1iPhone0Clipboards0 = "Or via the web server for public and authenticated browser access.";
WebServerTriggerAuthention1Browser1iPhone1Clipboards0 = "Or via the web server for public, authenticated, and iOS access.";
TutorialOffRails1= "I am afraid you have deviated from the path of this tutorial.  Please try again.";
kInstallFailed= "Keyboard Maestro Install Failed, redirecting to download page";
kDownloadCorrupted= "Keyboard Maestro Download Failed, corrupted file, redirecting to download page";
kDownloadFailed= "Keyboard Maestro Download Failed, redirecting to download page";
FeedbackPostscript= "(I am running Keyboard Maestro %@ on Mac OS X %@ and have so far saved %@)";
MacroGroupNotDeleted_Title= "Macro Group Not Deleted";
MacroGroupNotDeleted_DescriptionWith0MacrosAnd0MacroGroups= "Nothing was deleted, and one or more Macro Groups were not deleted because they contained macros that were not selected.";
MacroGroupNotDeleted_DescriptionWith1MacrosAnd0MacroGroups= "One macro was deleted but one or more Macro Groups were not deleted because they contained macros that were not selected.";
MacroGroupNotDeleted_DescriptionWith2MacrosAnd0MacroGroups= "%1$d macros were deleted, but one or more Macro Groups were not deleted because they contained macros that were not selected.";
MacroGroupNotDeleted_DescriptionWith0MacrosAnd1MacroGroups= "A Macro Group was deleted, but one or more Macro Groups were not deleted because they contained macros that were not selected.";
MacroGroupNotDeleted_DescriptionWith1MacrosAnd1MacroGroups= "A Macro Group and a macro were deleted but one or more Macro Groups were not deleted because they contained macros that were not selected.";
MacroGroupNotDeleted_DescriptionWith2MacrosAnd1MacroGroups= "A Macro Group and %1$d macros were deleted, but one or more Macro Groups were not deleted because they contained macros that were not selected.";
MacroGroupNotDeleted_DescriptionWith0MacrosAnd2MacroGroups= "%2$d Macro Groups was deleted, but one or more Macro Groups were not deleted because they contained macros that were not selected.";
MacroGroupNotDeleted_DescriptionWith1MacrosAnd2MacroGroups= "%2$d Macro Groups and a macro were deleted but one or more Macro Groups were not deleted because they contained macros that were not selected.";
MacroGroupNotDeleted_DescriptionWith2MacrosAnd2MacroGroups= "%2$d Macro Groups and %1$d macros were deleted, but one or more Macro Groups were not deleted because they contained macros that were not selected.";
GlobalMacroGroupNotDeleted_Title= "Global Macro Group Not Deleted";
GlobalMacroGroupNotDeleted_DescriptionWith0MacrosAnd0MacroGroups= "Nothing was deleted, and the Global Macro Groups is not allowed to be deleted (you can change it to Inactive if you desire).";
GlobalMacroGroupNotDeleted_DescriptionWith1MacrosAnd0MacroGroups= "One macro was deleted but the Global Macro Groups is not allowed to be deleted (you can change it to Inactive if you desire).";
GlobalMacroGroupNotDeleted_DescriptionWith2MacrosAnd0MacroGroups= "%1$d macros were deleted, but the Global Macro Groups is not allowed to be deleted (you can change it to Inactive if you desire).";
GlobalMacroGroupNotDeleted_DescriptionWith0MacrosAnd1MacroGroups= "A Macro Group was deleted, but the Global Macro Groups is not allowed to be deleted (you can change it to Inactive if you desire).";
GlobalMacroGroupNotDeleted_DescriptionWith1MacrosAnd1MacroGroups= "A Macro Group and a macro were deleted but the Global Macro Groups is not allowed to be deleted (you can change it to Inactive if you desire).";
GlobalMacroGroupNotDeleted_DescriptionWith2MacrosAnd1MacroGroups= "A Macro Group and %1$d macros were deleted, but the Global Macro Groups is not allowed to be deleted (you can change it to Inactive if you desire).";
GlobalMacroGroupNotDeleted_DescriptionWith0MacrosAnd2MacroGroups= "%2$d Macro Groups was deleted, but the Global Macro Groups is not allowed to be deleted (you can change it to Inactive if you desire).";
GlobalMacroGroupNotDeleted_DescriptionWith1MacrosAnd2MacroGroups= "%2$d Macro Groups and a macro were deleted but the Global Macro Groups is not allowed to be deleted (you can change it to Inactive if you desire).";
GlobalMacroGroupNotDeleted_DescriptionWith2MacrosAnd2MacroGroups= "%2$d Macro Groups and %1$d macros were deleted, but the Global Macro Groups is not allowed to be deleted (you can change it to Inactive if you desire).";
kInsertFunction = "Math
DOW([time]):DOW - Current or Specified Day of the Week (Sunday=1)
NoPreferencePanesAvailable = "No Preference Panes Available";
NumberPadSubmenu = "Key Pad";
FunctionKeySubmenu = "Function Key";
TabUniCharLong= "Tab";
DeleteUniCharShort= "‚å´";
EscapeUniCharShort= "‚éã";
ClearUniCharShort= "‚åß";
DeleteRightUniCharShort= "‚å¶";
PageUpUniCharShort= "‚áû";
PageDownUniCharShort= "‚áü";
HelpUniCharShort= "?";
HomeUniCharShort= "‚ÜñÔ∏é";
EndUniCharShort= "‚ÜòÔ∏é";
LeftArrowUniCharShort= "‚Üê";
RightArrowUniCharShort= "‚Üí";
DownArrowUniCharShort= "‚Üì";
UpArrowUniCharShort= "‚Üë";
ISOSectionUniCharShort= "¬ß";
ISOSectionUniCharLong= "Section Sign";
JISYenUniCharShort= "¬•";
JISYenUniCharLong= "JIS Yen";
JISUnderscoreUniCharShort= "‚íø_";
JISUnderscoreUniCharLong= "JIS Underscore";
JISKeypadCommaUniCharShort= "‚íø‚äû,";
JISKeypadCommaUniCharLong= "JIS Key Pad ,";
JISKeypadCommaUniCharName= "JIS Key Pad Comma";
JISEisuUniCharShort= "Eisu";
JISEisuUniCharLong= "JIS Eisu";
JISKanaUniCharShort= "Kana";
JISKanaUniCharLong= "JIS Kana";
NumberPadFormatShort= "‚äû%@";
NumberPadFormatLong= "Key Pad %@";
WidthCharacter = "‚Üî";
HeightCharacter = "‚Üï";
DownToCenterArrowCharacter = "‚§ì";
kCheckLocalizedStrings= "GOOD";
MenuGlyph6F = "F1";
MenuGlyph70 = "F2";
MenuGlyph71 = "F3";
MenuGlyph72 = "F4";
MenuGlyph73 = "F5";
MenuGlyph74 = "F6";
MenuGlyph75 = "F7";
MenuGlyph76 = "F8";
MenuGlyph77 = "F9";
MenuGlyph78 = "F10";
MenuGlyph79 = "F11";
MenuGlyph7A = "F12";
MenuGlyph87 = "F13";
MenuGlyph88 = "F14";
MenuGlyph89 = "F15";
MenuGlyph8F = "F16";
MenuGlyph90 = "F17";
MenuGlyph91 = "F18";
MenuGlyph92 = "F19";
kmKeystrokeBadAlreadyUsedStr= "The keystroke you have pressed for this hot key conflicts with a hot key in macro ‚Äò%@‚Äô.";
SIVCDescription= "Keyboard Maestro %@ is now available (you have %@).  Would you like to download and install it now?";
InstallFailedStr= "An error occurred while trying to instal the Keyboard Maestro update, redirecting to the download page.";
MacroGroupFrontWindowCondition_ExistsButTitleIsNot= "Available when there is a focused window but its title is not ‚Äú%@‚Äù.";
MacroGroupFrontWindowCondition_TitleContains= "Available when the focused window title contains ‚Äú%@‚Äù.";
MacroGroupFrontWindowCondition_TitleDoesNotContain= "Available when the focused window title does not contain ‚Äú%@‚Äù.";
MacroGroupFrontWindowCondition_ExistsButTitleDoesNotContain= "Available when there is a focused window but its title does not contain ‚Äú%@‚Äù.";
MacroGroupFrontWindowCondition_TitleMatches= "Available when the focused window title matches ‚Äú%@‚Äù.";
MacroGroupFrontWindowCondition_TitleDoesNotMatch= "Available when the focused window title does not match ‚Äú%@‚Äù.";
MacroGroupFrontWindowCondition_ExistsButTitleDoesNotMatch= "Available when there is a focused window but its title does not match ‚Äú%@‚Äù.";
csDeleteClipDataWarningStr= "Are you sure you want to delete the selected clipboard position(s)?";
AskPermissionStr                        = "Keyboard Maestro Engine is Required for Macros to Function";
AskPermissionText                       = "Keyboard Maestro will launch the Keyboard Maestro Engine which is what actually executes your macros and it should continue running after you quit Keyboard Maestro so that your macros continue to operate.\r\rYou only need the Keyboard Maestro editor when you change your macros.\r\rYou can quit the engine at any time by selecting Quit Keyboard Maestro Engine from the Keyboard Maestro status menu.  You should also enable Launch Engine at Login in the preferences so the engine will always be available.\r\rWhat should happen to the engine when you quit the Keyboard Maestro editor?\r";
AskPermissionKeepRunningButton          = "Keep Running";
AskPermissionAlwaysKeepRunningButton    = "Always Keep Running";
WarnAccessibilityTitle= "Accessibility Access is Required";
WarnAccessibilityMessage= "Accessibility access to control your computer is required to use many features including selecting menu items, manipulating windows, pressing buttons, typed string triggers and the window switcher.  Please enable Accessibility for Keyboard Maestro and Keyboard Maestro Engine in the Accessibility section of the Privacy section of the Security & Privacy system preference pane.";
WarnAccessibilityDefaultButton= "Open Preferences";
WarnAccessibilityIgnoreButton= "Later";
WarnAccessibilityNotAgainButton= "Don‚Äôt Ask Again";
UniversalAccessWarningMessage= "Accessibility access to control your computer is required to use many features selecting menu items, manipulating windows, pressing buttons, typed string triggers and the window switcher.\r\rPlease enable Accessibility for Keyboard Maestro and Keyboard Maestro Engine in the Accessibility section of the Privacy section of the Security & Privacy system preference pane.";
UniversalAccessWarningDefaultButton= "Open System Preferences";
WarnKMSwitcherConflictText= "Keyboard Maestro Engine is running and has its own switchers enabled.  These may conflict with the switchers provided by Switcher Maestro, so you might want to disable them.";
WarnPrefWriteFailedText= "Keyboard Maestro failed to write the preferences file. %@ %@ You should quit and fix the problem and then relaunch Keyboard Maestro.";
SharingDisabledBecauseOfNewerWarningMessage= "Syncing macros has been disabled because the macro sync file is from a newer version of Keyboard Maestro.  Update this version of Keyboard Maestro to resume sharing, otherwise your local changes will be destroyed when you do update.";
SecureInputWarningMessageNoWho= "Secure Input is enabled which means the system thinks you are currently in a password field and will not allow applications to monitor the keyboard.\r\rThis will stop typed string triggers from working, as well as stop Keyboard Maestro from sensing your keystrokes while setting hot keys.\r\rYou will need to find the application responsible (often 1Password or LastPass or their Chrome extensions) and quit it.";
SecureInputWarningMessageWithWho= "Secure Input is enabled which means the system thinks you are currently in a password field and will not allow applications to monitor the keyboard.\r\rThis will stop typed string triggers from working, as well as stop Keyboard Maestro from sensing your keystrokes while setting hot keys.\r\rYou will need to find the application responsible (probably %@) and quit it.";
Early1010WarningTitle= "Early Version of Yosemite";
Early1010WarningMessage= "You are running an early version of OS X 10.10 Yosemite.  Versions of Yosemite prior to 10.10.3 had serious bugs in the accessibility preference setting system, making it very difficult to enable accessibility for both Keyboard Maestro and especially Keyboard Maestro Engine.  It is strongly recommended that you upgrade to 10.10.3 or later if at all possible.";
NamedClipboardDeleteWarningMessage= "One or more of the Named Clipboards you are trying to delete is currently in use by a macro.  You can delete it, but it will soon be recreated.";
VariableDeleteWarningMessage= "One or more of the Variables you are trying to delete is currently in use by a macro.  You can delete it, but it may soon be recreated.";
SharingOpenWarningMessage= "Syncing from an existing macro sync file will replace all of your existing macros with the macros from the remote file you select.";
SyncCreateMacrosSuccessMessage= "The macros have been written to the sync file, and will be written whenever the local macros are changed. Any change to the sync file will result in the local macros being replaced from that file.";
SyncOpenMacrosSuccessMessage= "The macros have been replaced with those from sync file, and the macros will be written whenever the local macros are changed. Any change to the sync file will result in the local macros being replaced from that file.";
ShareLibrary_Success_Description0= "The file was written, but no macros were saved.";
ShareLibrary_Success_Description1= "One macro was saved to a library.";
ShareLibrary_Success_Description2= "%d macros were saved to a library.";
ShareActionsOrMacrosFailedHeader= "Failed to export %@.";
ShareActionsOrMacrosFailedMessage= "The attempt to export the %@ failed, the %@ have not been exported.";
ExportMacrosFailedHeader= "Failed to export macros.";
ExportMacrosFailedMessage= "The attempt to export the macros failed, the macros have not been exported.";
ExportMacros_Success_Title= "Exported Macros";
ExportMacros_Success_Description0= "The file was written, but no macros were exported.";
ExportMacros_Success_Description1= "One macro was exported.";
ExportMacros_Success_Description2= "%d macros were exported.";
ExportActionsFailedHeader= "Failed to export actions.";
ExportActionsFailedMessage= "The attempt to export the actions failed, the actions have not been exported.";
ExportActions_Success_Title= "Exported Actions";
ExportActions_Success_Description0= "The file was written, but no actions were exported.";
ExportActions_Success_Description1= "One action was exported.";
ExportActions_Success_Description2= "%d actions were exported.";
ImportActions_Success_Title= "Imported Actions";
ImportActions_Success_Description0= "The file was written, but no actions were importeded.";
ImportActions_Success_Description1= "One action was importeded.";
ImportActions_Success_Description2= "%d actions were importeded.";
ImportActions_CantImportErrorTitle= "Cannot Import Actions File";
ImportActions_CantImportError_UnknownExplanation= "The Actions File you selected is of an unknown format.";
ImportMacros_CantImportErrorTitle= "Cannot Import Macro File";
ImportMacros_CantImportError_UnknownExplanation= "The Macro File you selected is of an unknown format.";
ImportMacros_Success_Title= "Imported Macros";
ImportLibrary_CantImportErrorTitle= "Cannot Import Library File";
ImportLibrary_CantImportError_UnknownExplanation= "The Library File you select is of an unknown format.";
ImportLibrary_Success_Title= "Inserted Library";
Import_Success_Description000= "The file was read, but no macros were imported.";
Import_Success_Description001= "One smart group imported.";
Import_Success_Description002= "%%d smart groups imported.";
Import_Success_Description110= "One macro was imported.";
Import_Success_Description111= "One macro and one smart group were imported.";
Import_Success_Description112= "One macro and %%d smart groups were imported.";
Import_Success_Description210= "%d macros were imported into one macro group.";
Import_Success_Description211= "%d macros were imported into one macro group and one smart group was imported.";
Import_Success_Description212= "%d macros were imported into one macro group and %%d smart groups were imported.";
Import_Success_Description220= "%d macros were imported into %d macro groups.";
Import_Success_Description221= "%d macros were imported into %d macro groups and one smart group was imported.";
Import_Success_Description222= "%d macros were imported into %d macro groups and %%d smart groups were imported.";
MacroGroupDefaultName_GlobalTarget= "Macros for All Applications";
MacroGroupDefaultName_SpecificApps= "Macros for ";
MacroGroupDefaultName_ExcludedApps= "Macros Not Active In ";
MacroGroupDefaultName_AppSeperator= ", ";
NagWindowTitle= "Keyboard Maestro %@";
InvalidSerialMessage= "Make sure you enter your email address and serial number exactly as they appear on your registration acknowledgment email.";
OldSerialMessage= "The username and serial number you have entered is valid for an older version, you will need to enter your new serial number.";
PSShowMenu= "Show (s)";
PSHideMenu= "Hide (h)";
PSLaunchMenu= "Launch (l)";
PSLaunchAndHideOthersMenu= "Launch & Hide Others (d)";
PSSwitchMenu= "Activate (l)";
PSSwitchAndHideOthersMenu= "Activate & Hide Others (d)";
ALLaunchMenu= "Launch";
ALLaunchAndHideOthersMenu= "Launch & Hide Others";
SIVCLanguage= "EN";
AboutRegisteredTo= "Registered to: %@";
MacAppStoreVersion= "Mac App Store Version";
apmMore= "More‚Ä¶";
DefaultSearchTitle= "Search the web with Google";
DefaultSearchURL= "https://www.google.com/search?q=%Search%";
hkExecuteJavaScriptForCustomPrompt= "Execute a JavaScript in Custom Prompt";
hkExecuteJavaScriptForCustomPromptAll= "Execute a JavaScript in all Custom Prompts";
hkExecuteJavaScriptForCustomPromptTitle= "Execute a JavaScript in Custom Prompt with ID ‚Äò%@‚Äô";
hkSetClipboardToNamedClipboard= "Set Clipboard to Named Clipboard"; // depricated
hkSaveClipboardToNamedClipboard= "Save Clipboard to Named Clipboard"; // depricated
SelectMenuApplicationNotFound= "Select Menu Item failed to find target application for %@.";
SelectMenuApplicationNotFoundApp= "Select Menu Item failed to find target application ‚Äò%@‚Äô for %%@.";
SelectMenuBarNotFound= "Select Menu Item failed to find target menu bar for %@.";
SelectMenuItemNotFound= "Select Menu Item failed to find target menu item %@.";
SelectMenuItemDisabled= "Select Menu Item failed because the menu item %@ is disabled.";
SelectMenuItemFailed= "Menu selection failed to pick menu %@ with error %ld.";
SelectMenuItemRequiresAccess= "Select Menu Item action requires Accessibility which is disabled.";
PressButtonWindowNotFound= "Press Button ‚Äò%@‚Äô failed to find window.";
PressButtonButtonNotFound= "Press Button ‚Äò%@‚Äô failed to find button.";
PressButtonDisabled= "Press Button ‚Äò%@‚Äô failed because the button is disabled.";
PressButtonRequiresAccess= "Press Button action requires Accessibility which is disabled.";
MouseClickNoFrontWindow= "Move or Click Mouse no front window found.";
MouseClickNoImageFound= "Move or Click Mouse no unique image found.";
MouseClickNoImage= "Move or Click Mouse no image specified.";
MouseClickCalculateFailed= "Move or Click Mouse calculation %@ failed.";
TimeoutExceeded= "Action timeout exceeded.";
MacroCancelledFormat= "%@ Macro ‚Äò%@‚Äô cancelled (while executing %@).";
ActionFailedFormat= "%@ In macro ‚Äò%@‚Äô (while executing %@).";
kmModifierKeySeparator= "";
kmFKeyFormat= "F%d";
kmModifierControl= "Control";
kmModifierOption= "Option";
kmModifierShift= "Shift";
kmModifierCommand= "Command";
kmHiliteLocationTitleRectangle= "Highlight Rectangle at %@,%@,%@,%@";
kmHiliteLocationTitleOval= "Highlight Oval at %@,%@,%@,%@";
kmHiliteLocationTitleTarget= "Highlight Target at %@,%@,%@,%@";
kmExecuteAppleScriptType= "AppleScript";
kmExecuteJavaScriptType= "JavaScript in %@";
kmExecuteShellScriptType= "Shell Script";
kmExecuteJavaScriptForAutomationType= "JavaScript For Automation";
kmExecuteSwiftScriptType= "Swift Script";
//kmExecuteBaseScriptFileFormatResultsDescription= "The output of script ‚Äò%@‚Äô is:";
//kmExecuteBaseScriptTextScriptResultsDescription= "The output of the text script is:";
kmExecuteJavaScriptForCustomPromptResultsDescription= "The output of the script is:";
kmExecuteJavaScriptForCustomPromptResultsTitle= "JavaScript Results";
kMacroGroupToggleInternalAutomatic= "Internal Toggle Macro Group";
kMacroGroupToggleOnce= "Activate Macro Group for One Action";
kMacroGroupToggleActivate= "Activate Macro Group";
kMacroGroupToggleDeactivate= "Deactivate Macro Group";
kMacroGroupToggleToggle= "Activate/Deactivate Macro Group";
kMacroGroupToggleOnceWithPalette= "Show Macro Group for One Action";
kMacroGroupToggleShowPalette= "Show Macro Group";
kMacroGroupToggleHidePalette= "Hide Macro Group";
kMacroGroupToggleTogglePalette= "Show/Hide Macro Group";
kMacroGroupToggleInternalAutomaticFormat= "Internal Toggle Macro Group ‚Äò%@‚Äô";
kMacroGroupToggleOnceFormat= "Activate Macro Group ‚Äò%@‚Äô for One Action";
kMacroGroupToggleActivateFormat= "Activate Macro Group ‚Äò%@‚Äô";
kMacroGroupToggleDeactivateFormat= "Deactivate Macro Group ‚Äò%@‚Äô";
kMacroGroupToggleToggleFormat= "Activate/Deactivate Macro Group ‚Äò%@‚Äô";
kMacroGroupToggleOnceWithPaletteFormat= "Show Macro Group ‚Äò%@‚Äô for One Action";
kMacroGroupToggleShowPaletteFormat= "Show Macro Group ‚Äò%@‚Äô";
kMacroGroupToggleHidePaletteFormat= "Hide Macro Group ‚Äò%@‚Äô";
kMacroGroupToggleTogglePaletteFormat= "Show/Hide Macro Group ‚Äò%@‚Äô";
kmReadFileToClipboardTitleFormat= "Read File to Clipboard";
kmReadFileToNamedClipboardTitleFormat= "Read File to Named Clipboard ‚Äò%@‚Äô";
kmReadFileToVariableTitleFormat= "Read File to Variable ‚Äò%@‚Äô";
kmWriteFileFromClipboardTitleFormat= "%@ Clipboard";
kmWriteFileFromNamedClipboardTitleFormat= "%@ Named Clipboard ‚Äò%@‚Äô";
kmWriteFileFromVariableTitleFormat= "%@ Variable ‚Äò%@‚Äô";
kmWriteFileFromPlainTextTitleFormat= "%@ Text";
kmWriteFileFromStyledTextTitleFormat= "%@ Styled Text";
kmWriteFileMakeLongTitleFormat= "%@ to File";
kmActionTextSourceClipboard= "%@ of Clipboard";
kmActionTextSourceNamedClipboardFormat= "%@ of Named Clipboard ‚Äò%@‚Äô";
kmActionTextSourceVariableFormat= "%@ of Variable ‚Äò%@‚Äô";
kmActionTextSourceTextFormat= "%@ of Text ‚Äò%@‚Äô";
kmSubstringActionName= "Get Substring";
kmSwitchActionName= "Switch";
kmSubstringDestinationHTMLClipboard= "Store result to Clipboard";
kmSubstringDestinationHTMLNamedClipboardFormat= "Store result to Named Clipboard ‚Äò%@‚Äô";
kmSubstringDestinationHTMLVariableFormat= "Store result to Variable ‚Äò%@‚Äô";
kmCompositeImageClipboard= "Composite Clipboard onto Image";
kmCompositeImageText= "Composite Text onto Image";
kmCompositeImageHTMLClipboard= "Composite %@ onto Image in %@";
kmCompositeImageHTMLText= "Composite Text onto Image in %@";
kmNewFolderTitleLongFormat= "Create New Folder ‚Äò%@‚Äô";
kClipboardTargetNamedClipboardFormat= "Named Clipboard ‚Äò%@‚Äô";
kmApplyStyleHTMLDescriptionTitleFormat= "Apply Style to %@";
kmApplyTextFactoryHTMLDescriptionTitleFormat= "Apply Text Factory to %@";
kApplyStyleToTo= "Apply up to character %@";
kApplyStyleToFrom= "Apply from character %@";
kApplyStyleToLast= "Apply to last %@ characters";
kApplyStyleToRange= "Apply from character %@ length %@";
kApplyStyleToFromTo= "Apply from character %@ to character %@";
kSubstringRangeTo= "Subrange up to character %@";
kSubstringRangeFrom= "Subrange from character %@";
kSubstringRangeLast= "Subrange of last %@ characters";
kSubstringRangeRange= "Subrange from character %@ length %@";
kSubstringRangeFromTo= "Subrange from character %@ to character %@";
kSubstringRangeDeleteTo= "Subrange deleting up to character %@";
kSubstringRangeDeleteFrom= "Subrange deleting from character %@";
kSubstringRangeDeleteLast= "Subrange deleting last %@ characters";
kSubstringRangeDeleteRange= "Subrange deleting from character %@ length %@";
kSubstringRangeDeleteFromTo= "Subrange deleting from character %@ to character %@";
hkTrimImageHTMLTitle= "Trim Image in %@";
kmNewImageHTMLDescriptionTitleFormat= "Create New Image in %@";
kmDisplayImageFormat= "Display %@";
kmSetNetworkLocationFormat= "Set Network Location to ‚Äò%@‚Äô";
kmGetFileAttributeTitleFormat= "Get %@ to Variable ‚Äò%@‚Äô";
kmSetFileAttributeTitleFormat= "Set %@ to ‚Äò%@‚Äô";
kmOpen1FileTitleFormat= "Open ‚Äò%@‚Äô";
kmOpenPrefPaneTitleFormat= "Open %@ Preference Pane";
kmOpen1PasswordTitleFormat= "Open 1Password Bookmark %@‚Äô";
kmForTitle= "For Each Item in a Collection Execute Actions";
kmForHTMLTitle0= "For Each With No Collections Will Do Nothing";
kmForHTMLTitle1= "For Each Item in the Collection Execute Actions";
kmForHTMLTitle2= "For Each Item in these Collections Execute Actions";
kmSwitchIsDescription= "If it Is ‚Äú%@‚Äù";
kmSwitchIsNotDescription= "If it Is Not ‚Äú%@‚Äù";
kmSwitchContainsDescription= "If it Contains ‚Äú%@‚Äù";
kmSwitchDoesNotContainDescription= "If it Does Not Contain ‚Äú%@‚Äù";
kmSwitchMatchesDescription= "If it Matches ‚Äú%@‚Äù";
kmSwitchDoesNotMatchDescription= "If it Does Not Match ‚Äú%@‚Äù";
kmSwitchConformsToDescription= "If it Conforms To ‚Äú%@‚Äù";
kmSwitchDoesNotConformToDescription= "If it Does Not Conform To ‚Äú%@‚Äù";
hkDebuggerActionStepOverOthersTitle= "Debugger Step Over Other Macros";
hkDebuggerActionStepIntoOthersTitle= "Debugger Step Into Other Macros";
hkDebuggerActionStepOutOthersTitle= "Debugger Step Out Other Macros";
hkSpeakTextTitle= "Speak Text ‚Äò%@‚Äô";
hkSpeakTextVoiceTitle= "Speak Text With Voice ‚Äò%@‚Äô at %@ Rate";
hkSpeakTextDefaultVoiceTitle= "Speak Text With Default Voice ‚Äò%@‚Äô at %@ Rate";
hkSystemVolumeTitleFormat= "Set System Output Volume to %d%%";
hkSendMIDIMessageNoteOnTitleFormat= "Send MIDI channel %d note %d velocity %d";
hkSendMIDIMessageNoteOffTitleFormat= "Send MIDI channel %d note %d off";
hkSendMIDIMessageControlChangeTitleFormat= "Send MIDI channel %d control %d change to %d";
hkSendMIDIMessageNoteOnTitle= "Send MIDI Note On";
hkSendMIDIMessageNoteOffTitle= "Send MIDI Note Off";
hkSendMIDIMessageControlChangeTitle= "Send MIDI Control Change";
QuickTimePlayerCmd_StepForward_Title= "Step Forward Current Movie %@ Frames";
QuickTimePlayerCmd_StepForward_ShortTitle= "Step Forward Current Movie";
QuickTimePlayerCmd_StepBackward_Title= "Step Backward Current Movie %@ Frames";
QuickTimePlayerCmd_StepBackward_ShortTitle= "Step Backward Current Movie";
QuickTimePlayerCmd_IncreaseVolume_Title= "Increase Current Movie Volume by 10%";
QuickTimePlayerCmd_IncreaseVolume_ShortTitle= "Increase Current Movie Volume";
QuickTimePlayerCmd_DecreaseVolume_Title= "Decrease Current Movie Volume by 10%";
QuickTimePlayerCmd_DecreaseVolume_ShortTitle= "Decrease Current Movie Volume";
QuickTimePlayerCmd_SetVolume_TitleFormat= "Set Current Movie Volume to %d%%";
QuickTimePlayerCmd_SetVolume_Title= "Set Current Movie Volume";
aManipulateWindow_ResizeWindowByPercentFormat= "Scale %@ by Percent";
aManipulateWindow_ResizeWindowByFormat= "Resize %@ by Pixels";
aManipulateWindow_ResizeWindowToFormat= "Resize %@ to Pixels";
aManipulateWindow_MoveWindowByFormat= "Move %@ by Pixels";
aManipulateWindow_MoveWindowToFormat= "Move %@ to Position";
aManipulateWindow_MoveAndResizeFormat= "Move and Resize %@";
aManipulateWindow_CenterWindowFormat= "Center %@";
aManipulateWindow_CenterWindowAtFormat= "Center %@ at Position";
aManipulateWindow_CloseWindowFormat= "Close %@";
aManipulateWindow_ZoomWindowFormat= "Zoom %@";
aManipulateWindow_ReallyMinimizeWindowFormat= "Minimize %@";
aManipulateWindow_UnminimizeWindowFormat= "Unminimize %@";
aManipulateWindow_SelectWindowFormat= "Bring %@ to Front";
aManipulateWindow_FrontWindowName= "Front Window";
aManipulateWindow_NamedWindowFormat= "Window Named ‚Äò%@‚Äô";
aManipulateWindow_WindowWithNameContainingFormat = "Window(s) With Name Containing ‚Äò%@‚Äô";
aManipulateWindow_WindowWithIndexFormat= "Window With Index %@";
aManipulateWindow_New_SelectWindow= "Bring a Window to the Front";
kmScreenCaptureTitle= "Screen Capture %@";
kmScreenCaptureSourceScreenMain= "Screen Capture Main Screen";
kmScreenCaptureSourceScreenIndex= "Screen Capture Screen %@";
kmScreenCaptureSourceWindowFront= "Screen Capture Front Window";
kmScreenCaptureSourceWindowIndex= "Screen Capture Window %@";
kmScreenCaptureSourceWindowName= "Screen Capture Window ‚Äò%@‚Äô";
kmScreenCaptureSourceWindowNameContaining= "Screen Capture Window With Name Containing ‚Äò%@‚Äô";
kmScreenCaptureSourceWindowNameMatching= "Screen Capture Window With Name Matching ‚Äò%@‚Äô";
kHScreenAreaScreenIndexDescription= "Screen %@";
kHScreenAreaWindowNameDescription= "Window ‚Äò%@‚Äô";
kHScreenAreaWindowNameContainingDescription= "Window With Name Containing ‚Äò%@‚Äô";
kHScreenAreaWindowNameMatchingDescription= "Window With Name Matching ‚Äò%@‚Äô";
kHScreenAreaWindowIndexDescription= "Window %@";
kHScreenAreaAreaDescription= "Area (%@)";
kmDrawImageActionLine= "Draw a Line onto Image";
kmDrawImageActionRectangle= "Draw a Rectangle onto Image";
kmDrawImageActionOval= "Draw a Oval onto Image";
kmDrawImageActionHTML= "Draw onto Image in %@";
kmDrawImageLineHTML= "Draw a line from (%@,%@) to (%@,%@), %@ thick.";
kmDrawImageRectangleHTML= "Draw a rectangle from (%@,%@), %@ wide, %@ high, %@ thick.";
kmDrawImageOvalHTML= "Draw an oval centered (%@,%@), %@ wide, %@ high.";
kmTransformImageActionHTMLFlipHorizontal= "Flip Image in %@ Horizontally";
kmTransformImageActionHTMLFlipVertical= "Flip Image in %@ Vertically";
kmTransformImageActionHTMLRotateCW= "Rotate Image in %@ Clockwise";
kmTransformImageActionHTMLRotate180= "Rotate Image in %@ 180¬∞";
kmTransformImageActionHTMLRotateCCW= "Rotate Image in %@ Counter-Clockwise";
kmTransformImageActionHTMLFreeRotate= "Rotate Image in %@ by ‚Äò%@‚Äô";
kmGetImageSize= "Get Image %@ of %@";
kmResizeImageActionHTMLScaleTo= "Resize Image in %@";
kmResizeImageActionHTMLResizeTo= "Resize Canvas in %@";
kmResizeImageActionHTMLAddMargin= "Add or Remove Margins to Image in %@";
kmResizeImageActionHTMLCrop= "Crop Image in %@";
aSummaryReturnFormat= "%@‚Ü©";
aSummaryTextFormat= "%@‚Ä¶";
aInsertText_DisplayDescription= "The text is:";
aFastUserSwitch_DescriptionFormat= "Fast User Switch to ‚Äò%@‚Äô";
aSetKeyboardLayout_DescriptionFormat= "Set Keyboard Layout to ‚Äò%@‚Äô";
kmSimulateHardwareKeyPressAndReleaseTitleFormat= "Simulate the Hardware Key %@";
kmSimulateHardwareKeyPressAndHoldTitleFormat= "Press and Hold the Hardware Key %@";
kmSimulateHardwareKeyPressAndRepeatTitleFormat= "Press and Repeat the Hardware Key %@";
kmSimulateHardwareKeyReleaseTitleFormat= "Release the Hardware Key %@";
aSetClipboardToText_StyledText= "Styled Text";
aSetClipboardToText_DescriptionFormat= "Set %@ to %@";
aSetClipboardToText_DescriptionExtendedFormat= "%@ ‚Äò%@‚Äô";
aSetClipboardToText_DisplayDescription= "The clipboard would be:";
aSetVariableToText_DescriptionFormat= "Set Variable ‚Äò%@‚Äô to Text ‚Äò%@‚Äô";
aSetVariableToText_HTMLFormat= "Set Variable ‚Äò%@‚Äô to Text";
aSetVariableToSafariField_DescriptionFormat= "Set Variable ‚Äò%@‚Äô to %@ Field ‚Äò%@‚Äô";
aSetVariableToSafariField_NewActionFormat= "Set Variable to %@ Field";
aSetVariableToCalculation_DescriptionFormat= "Set Variable ‚Äò%@‚Äô To Calculation ‚Äò%@‚Äô";
aSetActionDelay00_DescriptionFormat= "Set %@ Delay for This Macro to %@ Seconds";
aSetActionDelay01_DescriptionFormat= "Set %@ Delay Globally to %@ Seconds";
aSetActionDelay10_DescriptionFormat= "Reset %@ Delay for This Macro to %@ Seconds";
aSetActionDelay11_DescriptionFormat= "Reset %@ Delay Globally to %@ Seconds";
aSetFindPasteboard_DescriptionFormat= "Set Find Pasteboard to Text ‚Äò%@‚Äô";
aSetVariableToKeychainPassword_DescriptionFormat= "Set Variable ‚Äò%@‚Äô to Keychain Password ‚Äò%@‚Äô";
aSetKeychainPasswordToText_DescriptionFormat= "Set Keychain Password ‚Äò%@‚Äô to Text ‚Äò%@‚Äô";
aSetSafariFieldToText_DescriptionFormat= "Set %@ Field ‚Äò%@‚Äô to Text";
aSetSafariFieldToText_NewActionFormat= "Set %@ Field to Text";
aSetSafariCheckbox_DescriptionCheckedFormat= "Set %@ Checkbox ‚Äò%@‚Äô to checked";
aSetSafariCheckbox_DescriptionUncheckedFormat= "Set %@ Checkbox ‚Äò%@‚Äô to unchecked";
aSetSafariCheckbox_DescriptionValueFormat= "Set %@ Checkbox ‚Äò%@‚Äô to ‚Äò%@‚Äô";
aSetSafariCheckbox_NewActionFormat= "Set %@ Checkbox";
aSetSafariRadio_DescriptionFormat= "Set %@ Radio Button ‚Äò%@‚Äô to ‚Äò%@‚Äô";
aSetSafariRadio_NewActionFormat= "Set %@ Radio Button";
kSetMailStatus_DescriptionOnFormat = "Set Mail %@ to On";
kSetMailStatus_DescriptionOffFormat = "Set Mail %@ to Off";
kSetMailStatus_DescriptionFormat = "Set Mail %@ to %@";
kMailFlagIndex= "Flag Index";
kMailFlagged= "Flagged Status";
kMailJunk= "Junk Status";
kMailRead= "Read Status";
kMailStatus0= "Off";
kMailStatus1= "On";
kMailFlagIndex0= "Unflagged";
kMailFlagIndex1= "Red";
kMailFlagIndex2= "Oragne";
aMailSendMessage_DescriptionFormat= "Send Mail Message with Subject ‚Äò%@‚Äô";
aExecuteJavaScript_NewActionFormat= "Execute a JavaScript in %@";
aPromptForUserInput_Format= "Prompt for User Input ‚Äò%@‚Äô";
hkFilterClipboardTitleFormat= "Filter %@ with %@";
hkFilterVariableTitleFormat= "Filter Variable ‚Äò%@‚Äô with %@";
kFilterRemoveStyles= "Remove Styles";
kFilterMacLineEndings= "Mac Line Endings";
kFilterUnixLineEndings= "Unix Line Endings";
kFilterWindowsLineEndings= "Windows Line Endings";
kFilterTrimWhitespace= "Trim Whitespace";
kFilterUnwrap= "Unwrap";
kFilterLowercase= "Lowercase";
kFilterLowercaseFirst= "Lowercase First";
kFilterUppercase= "Uppercase";
kFilterUppercaseFirst= "Uppercase First";
kFilterTitleCase= "Title Case";
kFilterDumbQuotes= "Dumb Quotes";
kFilterFrenchQuotes= "French Quotes";
kFilterSpaces= "Spaces";
kFilterTabs= "Tabs";
kFilterEncodeHTMLEntities= "Encode HTML Entities";
kFilterEncodeNonASCIIHTMLEntities= "Encode Non-ASCII HTML Entities";
kFilterDecodeHTMLEntities= "Decode HTML Entities";
kFilterMakeHTMLList= "HTML List";
kFilterPercentEncodeForURL= "Percent Encode for URL";
kFilterPercentDecodeURL= "Percent Decode URL";
kFilterQuoteForAppleScript= "Quote for AppleScript";
kFilterQuoteForJavaScript= "Quote for JavaScript";
kFilterQuoteForShellScript= "Quote for Shell Script";
kFilterQuoteForSwift= "Quote for Swift";
kFilterLastPathComponent= "Last Path Component";
kFilterDeleteLastPathComponent= "Delete Last Path Component";
kFilterPathExtension= "Path Extension";
kFilterDeletePathExtension= "Delete Path Extension";
kFilterExpandTildeInPath= "Expand Tilde In Path";
kFilterAbbreviateWithTildeInPath= "Abbreviate With Tilde In Path";
kFilterResolveSymlinks= "Resolve Symlinks";
kFilterStandardizePath= "Standardize Path";
kFilterZapControlCharacters= "Zap Control Characters";
kFilterBulletControlCharacters= "Bullet Control Characters";
kFilterCalculate= "Calculate";
kFilterProcessTokens= "Process Tokens";
kFilterValueOfNamedVariable= "Value of Named Variable";
kFilterValueOfNamedClipboard= "Value of Named Clipboard";
kFilterCharacterCount= "Character Count";
kFilterLineCount= "Line Count";
SearchReplaceClipboardActionType::kCaseSensitiveString= "Search and Replace %@ With String Matching (case sensitive)";
SearchReplaceClipboardActionType::kIgnoreCaseString= "Search and Replace %@ With String Matching (ignoring case)";
SearchReplaceClipboardActionType::kCaseSensitiveRegEx= "Search and Replace %@ Using Regular Expression (case sensitive)";
SearchReplaceClipboardActionType::kIgnoreCaseRegEx= "Search and Replace %@ Using Regular Expression (ignoring case)";
SearchReplaceVariableActionType::kCaseSensitiveString= "Search and Replace Variable ‚Äò%@‚Äô With String Matching (case sensitive)";
SearchReplaceVariableActionType::kIgnoreCaseString= "Search and Replace Variable ‚Äò%@‚Äô With String Matching (ignoring case)";
SearchReplaceVariableActionType::kCaseSensitiveRegEx= "Search and Replace Variable ‚Äò%@‚Äô Using Regular Expression (case sensitive)";
SearchReplaceVariableActionType::kIgnoreCaseRegEx= "Search and Replace Variable ‚Äò%@‚Äô Using Regular Expression (ignoring case)";
SearchVariableActionType::kCaseSensitiveRegEx= "Search Variable ‚Äò%@‚Äô Using Regular Expression (case sensitive)";
SearchVariableActionType::kIgnoreCaseRegEx= "Search Variable ‚Äò%@‚Äô Using Regular Expression (ignoring case)";
SearchClipboardActionType::kCaseSensitiveRegEx= "Search %@ Using Regular Expression (case sensitive)";
SearchClipboardActionType::kIgnoreCaseRegEx= "Search %@ Using Regular Expression (ignoring case)";
UseVariableActionType::kSetMouse= "Use Variable ‚Äò%@‚Äô to Set the Mouse Location";
UseVariableActionType::kSetWindowPosition= "Use Variable ‚Äò%@‚Äô to Set the Front Window Position";
UseVariableActionType::kSetWindowSize= "Use Variable ‚Äò%@‚Äô to Set the Front Window Size";
UseVariableActionType::kSetWindowFrame= "Use Variable ‚Äò%@‚Äô to Set the Front Window Frame";
UseVariableActionType::kSetWindowByName= "Use Variable ‚Äò%@‚Äô to Set the Front Window by Name";
UseVariableActionType::kSetWindowByNameContains= "Use Variable ‚Äò%@‚Äô to Set the Front Window by Name Contains";
UseVariableActionType::kSetWindowByNameMatches= "Use Variable ‚Äò%@‚Äô to Set the Front Window by Name Matching";
UseVariableActionType::kSetApplicationByName= "Use Variable ‚Äò%@‚Äô to Set the Front Application by Name";
UseVariableActionType::kSetApplicationByNameContains= "Use Variable ‚Äò%@‚Äô to Set the Front Application by Name Containing";
UseVariableActionType::kSetApplicationByNameMatches= "Use Variable ‚Äò%@‚Äô to Set the Front Application by Name Matching";
UseVariableActionType::kSetSystemVolume= "Use Variable ‚Äò%@‚Äô to Set the System Volume";
WriteFileFormatRTF= "RTF";
WriteFileFormatRTFD= "RTFD";
WriteFileFormatSimpleText= "Simple Text";
WriteFileFormatHTML= "HTML";
WriteFileFormatWebArchive= "Web Archive";
WriteFileFormatWordDoc= "Word Doc";
WriteFileFormatWordML= "Word ML";
WriteFileFormatOfficeOpenXML= "Office Open XML";
WriteFileFormatOpenDocument= "Open Document";
WriteFileFormatPNG= "PNG";
WriteFileFormatTIFF= "TIFF";
WriteFileFormatJPEG= "JPEG";
WriteFileFormatBMP= "BMP";
WriteFileFormatGIF= "GIF";
WriteFileEncodingMacRoman= "Mac Roman";
WriteFileEncodingLatin1= "ISO Latin 1";
WriteFileEncodingUTF8= "UTF8";
WriteFileEncodingUTF16= "UTF16";
aQuickMacro_DescriptionFormat= "Record Quick Macro for Hot Key %@";
aQuickMacro_TargetNameFormat= "%@ [Quick Macro]";
aMacroGroupToggle_TargetNameFormat= "%@ [Macro Group]";
aPressButton_DescriptionFormat= "Press Button ‚Äò%@‚Äô";
hkSemaphoreLock_DescriptionFormat= "Semaphore Lock ‚Äò%@‚Äô";
hkSemaphoreUnlock_DescriptionFormat= "Semaphore Unlock ‚Äò%@‚Äô";
hkSemaphoreReset_DescriptionFormat= "Semaphore Reset ‚Äò%@‚Äô";
SemaphoreUnlockFailed= "Semaphore Unlock ‚Äò%@‚Äô failed on unlocked semaphore";
aCSMacroAction_PasteFormat= "Paste from Named Clipboard ‚Äò%@‚Äô";
aCSMacroAction_CopyFormat= "Copy to Named Clipboard ‚Äò%@‚Äô";
aCSMacroAction_CutFormat= "Cut to Named Clipboard ‚Äò%@‚Äô";
aCSMacroAction_PasteTitle= "Paste from Named Clipboard";
aCSMacroAction_CopyTitle= "Copy to Named Clipboard";
aCSMacroAction_CutTitle= "Cut to Named Clipboard";
aSetClipboardToNamedClipboardFormat= "Set Clipboard to Named Clipboard ‚Äò%@‚Äô";
aSaveClipboardToNamedClipboardFormat= "Save Clipboard to Named Clipboard ‚Äò%@‚Äô";
aSetClipboardToPastClipboardFormat= "Set %@ to Past Clipboard %@";
aCopyClipboardNothing= "Copy Nothing";
aCopyClipboard= "Copy %@ to %@";
aDeletePastClipboardFormat= "Delete Past Clipboard %@";
UnitsIn1Second= "1 second";
UnitsInSeconds= "%d seconds";
UnitsIn1Minute= "1 minute";
UnitsInMinutes= "%d minutes";
UnitsIn1Hour= "1 hour";
UnitsInHours= "%d hours";
UnitsIn1Day= "1 day";
UnitsInDays= "%d days";
tUSBDeviceTriggerTitle= "USB Device Trigger";
tVolumeTriggerTitle= "Mounted Volume Trigger";
tFocusedWindowTriggerTitle= "Focused Window Trigger";
tFolderTriggerTitle= "Folder Trigger";
tHIDTriggerTitle= "Device Trigger";
tTypedStringTriggerTitle= "Typed String Trigger";
tApplicationTriggerTitle= "Application Trigger";
tTimeTriggerTitle= "Time of Day Trigger";
tWhileLoggedInTriggerTitle= "While Logged In Trigger";
tLoginTriggerTitle= "Login Trigger";
tLaunchTriggerTitle= "Launch Trigger";
tGlobalMacroPaletteTitle= "Global Macro Palette Trigger";
tStatusMenuTitle= "Status Menu Trigger";
tWakeTitle= "Wake Trigger";
tSleepTitle= "Sleep Trigger";
tClipboardTitle= "Clipboard Trigger";
tPublicWebTitle= "Public Web Trigger";
tScriptTitle= "Script Trigger";
tWirelessNetworkTriggerTitle= "Wireless Network Trigger";
tHotKeyTriggerDescPressedFormat= "The Hot Key %@ is pressed";
tHotKeyTriggerDescWhileDownFormat= "While the Hot Key %@ is down";
tHotKeyTriggerDescReleasedFormat= "The Hot Key %@ is released";
tHotKeyTriggerDescTappedFormat= "The Hot Key %@ is tapped";
tHotKeyTriggerDescTappedOnceFormat= "The Hot Key %@ is tapped once";
tHotKeyTriggerDescTappedTwiceFormat= "The Hot Key %@ is tapped twice";
tHotKeyTriggerDescTappedTimesFormat= "The Hot Key %@ is tapped %d times";
tMIDITriggerDescPressedFormat= "The MIDI note %d is pressed";
tMIDITriggerDescWhileDownFormat= "While the MIDI note %d is down";
tMIDITriggerDescReleasedFormat= "The MIDI note %d is released";
tMIDITriggerShortDescFormat= "‚ô™%d";
tUSBTriggerAny= "Any USB Device is %%@";
tUSBTriggerNamed= "USB Device ‚Äò%@‚Äô is %%@";
tUSBTriggerContaining= "USB Device with Name Containing ‚Äò%@‚Äô is %%@";
tUSBTriggerMatching= "USB Device with Name Matching ‚Äò%@‚Äô is %%@";
tUSBTriggerAttached= "Attached";
tUSBTriggerDetached= "Detached";
tUSBTriggerShortDesc= "USB";
tVolumeTriggerAny= "Any Volume is %%@";
tVolumeTriggerNamed= "Volume ‚Äò%@‚Äô is %%@";
tVolumeTriggerContaining= "Volume with Name Containing ‚Äò%@‚Äô is %%@";
tVolumeTriggerMatching= "Volume with Name Matching ‚Äò%@‚Äô is %%@";
tVolumeTriggerShortDesc= "üíø";
tFolderTriggerAddImmediate= "Anything is added to folder ‚Äò%@‚Äô (immediately)";
tFolderTriggerAddIgnorePartial= "Anything is added to folder ‚Äò%@‚Äô (ignoring partial files)";
tFolderTriggerAddWaitCompletion= "Anything is added to folder ‚Äò%@‚Äô (ignoring partial or changing files)";
tFolderTriggerRemoveImmediate= "Anything is removed from folder ‚Äò%@‚Äô (immediately)";
tFolderTriggerRemoveIgnorePartial= "Anything is removed from folder ‚Äò%@‚Äô (ignoring partial files)";
tFolderTriggerBothImmediate= "Anything is added to or removed from folder ‚Äò%@‚Äô (immediately)";
tFolderTriggerBothIgnorePartial= "Anything is added to or removed from folder ‚Äò%@‚Äô (ignoring partial files)";
tFolderTriggerBothWaitCompletion= "Anything is added to or removed from folder ‚Äò%@‚Äô (ignoring partial or changing files)";
tFolderTriggerShortDesc= "üìÅ";
tWirelessNetworkTriggerAny= "Any Wireless Network is %%@";
tWirelessNetworkTriggerNameIs= "Wireless Network ‚Äò%@‚Äô is %%@";
tWirelessNetworkTriggerNameContains= "Wireless Network with Name Containing ‚Äò%@‚Äô is %%@";
tWirelessNetworkTriggerNameMatches= "Wireless Network with Name Matching ‚Äò%@‚Äô is %%@";
tWirelessNetworkTriggerBSSID= "Wireless Network with BSSID ‚Äò%@‚Äô is %%@";
tWirelessNetworkTriggerShortDesc= "‚úà";
tHIDTriggerShortDescFormat= "‚öÄ%@";
tTypeStringTriggerDescWithoutDeleteFormat= "The %@%@ ‚Äò%@‚Äô is typed (no deletes)";
tTypeStringTriggerDescWithDeleteFormat= "The %@%@ ‚Äò%@‚Äô is typed (then deleted)";
tTypeStringSpaceShort= "‚óá";
tTypeStringSpaceLong= "¬´Space¬ª";
tTypeStringTabShort= "‚á•";
tTypeStringTabLong= "¬´Tab¬ª";
tTypeStringReturnShort= "¬´Return¬ª";
tTypeStringReturnLong= "‚Ü©";
tTypeStringEnterShort= "¬´Enter¬ª";
tTypeStringEnterLong= "‚å§";
tTypeStringDiacriticalsMatterWordBreak= " (after a word break)";
tTypeStringDiacriticalsDontMatterAnywhere= " (ignoring diacriticals)";
tTypeStringDiacriticalsDontMatterWordBreak= " (after a word break, ignoring diacriticals)";
tTimeTrigger_DescFormat= "At %@ %@";
tTimeTrigger_TimeFormat= "%d:%02d";
tTimeTrigger_TimeBetweenFormat= "%d:%02d-%d:%02d";
tTimeTrigger_WhileLoggedInDescFormat= "Every %@ between %@ %@";
tTimeTrigger_EveryDay= "every day";
tTimeTrigger_Weekends= "weekends";
tTimeTrigger_NoDays= "No Days";
tTimeTrigger_WorkdaysAndWekendDays= "%@ and %@";
tTimeTrigger_CertainDaysFormat= "on %@";
tTimeTrigger_WeekdayRange= "%@-%@";
tTimeTrigger_RepeatingFormat= " repeating every %d %@";
tStatusMenuTrigger_LongDescription= "The Status Menu";
StatusMenuEmptyItem= "No Active Status Menu Triggers";
StatusMenuTriggerNoStatusMenu= "This macro will be listed in the status menu WHICH IS CURRENTLY DISABLED so this trigger will never fire.";
tPublicWebTrigger_LongDescription= "Via Public Web Access";
tPublicWebTrigger_ShortDescription= "Public Web";
tWakeTrigger_LongDescription= "At System Wake";
tWakeTrigger_ShortDescription= "Wake";
tSleepTrigger_LongDescription= "At System Sleep";
tSleepTrigger_ShortDescription= "Sleep";
tClipboardTrigger_LongDescription= "System Clipboard Changed";
TriggerByNameFormat= "Name Search for ‚Äò%@‚Äô";
TriggerByWebServer= "Web Server for ‚Äò%@‚Äô";
TriggerByURLScheme= "URL Scheme (kmtrigger) for ‚Äò%@‚Äô";
TriggerByCustomPrompt= "Custom HTML Prompt for ‚Äò%@‚Äô";
TriggerByMacroGroupPalette= "Macro Set Palette";
TriggerByDuplicateMacroPalette= "Duplicate Macro Palette";
TriggerByExecuteMacro= "Execute Macro";
TriggerByDoScript= "Do Script";
clRangeTitle= "Number Range Collection";
clRange_LongDescription= "The numbers from %@ to %@";
clRangeDown_LongDescription= "The numbers from %@ down to %@";
clApplicationsTitle= "Running Applications Collection";
clApplications_LongDescription= "The running applications";
clFilesTitle= "Folder Contents Collection";
clFiles_LongDescription= "The direct contents of folder ‚Äò%@‚Äô";
clFilesRecursive_LongDescription= "The recursive contents of folder ‚Äò%@‚Äô";
clFinderSelectionTitle= "Finder‚Äôs Selection Collection";
clFinderSelection_LongDescription= "The items in the Finder selection";
clFoundImagesTitle= "Found Images Collection";
clFoundImages_LongDescription= "The matching images found on the screen";
clVolumesTitle= "Mounted Volumes Collection";
clVolumes_LongDescription= "The mounted volumes";
clLinesInClipboardTitle= "Lines In Collection";
clLinesInClipboard_LongDescription= "The lines in the current clipboard";
clLinesInVariable_LongDescription= "The lines in variable ‚Äò%@‚Äô";
clLinesInFile_LongDescription= "The lines in file ‚Äò%@‚Äô";
clLinesInSystemClipboard_LongDescription= "The lines in system clipboard";
clLinesInNamedClipboard_LongDescription= "The lines in Named Clipboard ‚Äò%@‚Äô";
clSubstringsInTitle= "Substrings In Collection";
clSubstringsInVariable_LongDescription= "The substrings in variable ‚Äò%@‚Äô";
clSubstringsInFile_LongDescription= "The substrings in file ‚Äò%@‚Äô";
clSubstringsInSystemClipboard_LongDescription= "The substrings in system clipboard";
clSubstringsInNamedClipboard_LongDescription= "The substrings in Named Clipboard ‚Äò%@‚Äô";
clPastClipboardsTitle= "Clipboard History Collection";
clPastClipboards_LongDescription= "The past text clipboards";
cFrontWindow_LongDescription_Exists= "Front window exists";
cFrontWindow_LongDescription_DoesNotExist= "Front window does not exist";
cFrontWindow_LongDescription_TitleIs= "Front window title is ‚Äò%@‚Äô";
cFrontWindow_LongDescription_TitleIsNot= "Front window title is not ‚Äò%@‚Äô";
cFrontWindow_LongDescription_ExistsButTitleIsNot= "Front window exists but title is not ‚Äò%@‚Äô";
cFrontWindow_LongDescription_TitleContains= "Front window title contains ‚Äò%@‚Äô";
cFrontWindow_LongDescription_TitleDoesNotContain= "Front window title does not contain ‚Äò%@‚Äô";
cFrontWindow_LongDescription_ExistsButTitleDoesNotContain= "Front window exists but title does not contain ‚Äò%@‚Äô";
cFrontWindow_LongDescription_TitleMatches= "Front window title matches ‚Äò%@‚Äô";
cFrontWindow_LongDescription_TitleDoesNotMatch= "Front window title does not match ‚Äò%@‚Äô";
cFrontWindow_LongDescription_ExistsButTitleDoesNotMatch= "Front window exists but title does not match ‚Äò%@‚Äô";
cAnyWindowTitle= "Any Window Condition";
cAnyWindow_LongDescription_TitleIs= "Any window title is ‚Äò%@‚Äô";
cAnyWindow_LongDescription_TitleIsNot= "Any window title is not ‚Äò%@‚Äô";
cAnyWindow_LongDescription_TitleContains= "Any window title contains ‚Äò%@‚Äô";
cAnyWindow_LongDescription_TitleDoesNotContain= "Any window title does not contain ‚Äò%@‚Äô";
cAnyWindow_LongDescription_TitleMatches= "Any window title matches ‚Äò%@‚Äô";
cAnyWindow_LongDescription_TitleDoesNotMatch= "Any window title does not match ‚Äò%@‚Äô";
cButtonTitle= "Button Condition";
cButton_LongDescription_Exists= "Button %@ ‚Äò%@‚Äô exists";
cButton_LongDescription_DoesNotExist= "Button %@ ‚Äò%@‚Äô does not exist";
cButton_LongDescription_IsEnabled= "Button %@ ‚Äò%@‚Äô is enabled";
cButton_LongDescription_IsNotEnabled= "Button %@ ‚Äò%@‚Äô is not enabled";
cButton_LongDescription_ExistsButIsNotEnabled= "Button %@ ‚Äò%@‚Äô exists but is not enabled";
cButton_LongDescription_IsOff= "Button %@ ‚Äò%@‚Äô is off";
cButton_LongDescription_IsOn= "Button %@ ‚Äò%@‚Äô is on";
cButton_LongDescription_IsMixed= "Button %@ ‚Äò%@‚Äô is mixed";
cButtonSelection_Is= "with name";
cButtonSelection_Contains= "with name containing";
cButtonSelection_Matches= "with name matching";
cWirelessNetworkTitle= "Wireless Network Condition";
cWirelessNetwork_AnyConnected= "Any wireless network is connected";
cWirelessNetwork_AnyNotConnected= "No wireless network is connected";
cWirelessNetwork_OtherIsConnected= "A wireless network %@ is connected";
cWirelessNetwork_OtherIsNotConnected= "A wireless network %@ is not connected";
cWirelessNetworkSelection_NameIs= "with name ‚Äò%@‚Äô";
cWirelessNetworkSelection_NameContains= "with name containing ‚Äò%@‚Äô";
cWirelessNetworkSelection_NameMatches= "with name matching ‚Äò%@‚Äô";
cWirelessNetworkSelection_BSSID= "with BSSID ‚Äò%@‚Äô";
cUSBDeviceTitle= "USB Device Condition";
cUSBDevice_LongDescription_Exists= "USB device %@ ‚Äò%@‚Äô exists";
cUSBDevice_LongDescription_DoesNotExist= "USB device %@ ‚Äò%@‚Äô does not exist";
cMenuTitle= "Menu Condition";
cMenu_LongDescription_Exists= "Menu %@ ‚Äò%@‚Äô exists";
cMenu_LongDescription_DoesNotExist= "Menu %@ ‚Äò%@‚Äô does not exist";
cMenu_LongDescription_IsEnabled= "Menu %@ ‚Äò%@‚Äô is enabled";
cMenu_LongDescription_IsNotEnabled= "Menu %@ ‚Äò%@‚Äô is not enabled";
cMenu_LongDescription_ExistsButIsNotEnabled= "Menu %@ ‚Äò%@‚Äô exists but is not enabled";
cMenu_LongDescription_IsMarked= "Menu %@ ‚Äò%@‚Äô is marked";
cMenu_LongDescription_IsNotMarked= "Menu %@ ‚Äò%@‚Äô is not marked";
cMenu_LongDescription_ExistsButIsNotMarked= "Menu %@ ‚Äò%@‚Äô exists but is not marked";
cMenuSelection_Path= "with path";
cMenuSelection_Shortcut= "with shortcut";
cModifiers_LongDescription_Always = "The modifiers are in any state (always true)";
cModifiers_LongDescription_JustDown = "The modifiers %@ are down";
cModifiers_LongDescription_JustUp = "The modifiers %@ are up";
cModifiers_LongDescription_Both = "The modifiers %@ are down, and %@ are up";
cKeyTitle= "Key Condition";
cKey_LongDescription_Down= "The key %@ is down";
cKey_LongDescription_Up= "The key %@ is up";
cTypedStringTitle= "Typed String Condition";
cTypedString_LongDescriptionTitle= "The typed string was %@";
cTypedStringNone= "lowercase";
cTypedStringTitleCase= "title case";
cTypedStringUpperCase= "uppercase";
cDiskTitle= "Mounted Volume Condition";
cDisk_LongDescription_Exists= "Mounted Volume %@ ‚Äò%@‚Äô exists";
cDisk_LongDescription_DoesNotExist= "Mounted Volume %@ ‚Äò%@‚Äô does not exist";
cPathTitle= "Path Condition";
cPath_LongDescription_NothingExists= "Nothing exists at path ‚Äò%@‚Äô";
cPath_LongDescription_SomethingExists= "Something exists at path ‚Äò%@‚Äô";
cPath_LongDescription_FileExists= "A file exists at path ‚Äò%@‚Äô";
cPath_LongDescription_FileDoesNotExists= "A file does not exist at path ‚Äò%@‚Äô";
cPath_LongDescription_FolderExists= "A folder exists at path ‚Äò%@‚Äô";
cPath_LongDescription_FolderDoesNotExists= "A folder does not exist at path ‚Äò%@‚Äô";
cClipboardTitle= "Clipboard Condition";
cClipboard_LongDescription_HasText= "The clipboard has some text";
cClipboard_LongDescription_DoesNotHaveText= "The clipboard does not have any text";
cClipboard_LongDescription_HasImage= "The clipboard has an image";
cClipboard_LongDescription_DoesNotHaveImage= "The clipboard does not have an image";
cClipboard_LongDescription_Is= "The clipboard text is ‚Äò%@‚Äô";
cClipboard_LongDescription_IsNot= "The clipboard text is not ‚Äò%@‚Äô";
cClipboard_LongDescription_IsBefore= "The clipboard text is before ‚Äò%@‚Äô";
cClipboard_LongDescription_IsAfter= "The clipboard text is after ‚Äò%@‚Äô";
cClipboard_LongDescription_Contains= "The clipboard text contains ‚Äò%@‚Äô";
cClipboard_LongDescription_DoesNotContain= "The clipboard text does not contain ‚Äò%@‚Äô";
cClipboard_LongDescription_Matches= "The clipboard text matches ‚Äò%@‚Äô";
cClipboard_LongDescription_DoesNotMatch= "The clipboard text does not match ‚Äò%@‚Äô";
cClipboard_LongDescription_ConformsTo= "The clipboard text conforms to ‚Äò%@‚Äô";
cClipboard_LongDescription_DoesNotConformTo= "The clipboard text does not conform to ‚Äò%@‚Äô";
cVariable_LongDescription_Exists= "The variable ‚Äò%@‚Äô exists";
cVariable_LongDescription_DoesNotExist= "The variable ‚Äò%@‚Äô does not exist";
cVariable_LongDescription_IsEmpty= "The variable ‚Äò%@‚Äô is empty";
cVariable_LongDescription_IsNotEmpty= "The variable ‚Äò%@‚Äô is not empty";
cVariable_LongDescription_Is= "The variable ‚Äò%@‚Äô is ‚Äò%@‚Äô";
cVariable_LongDescription_IsNot= "The variable ‚Äò%@‚Äô is not ‚Äò%@‚Äô";
cVariable_LongDescription_IsBefore= "The variable ‚Äò%@‚Äô is before ‚Äò%@‚Äô";
cVariable_LongDescription_IsAfter= "The variable ‚Äò%@‚Äô is after ‚Äò%@‚Äô";
cVariable_LongDescription_Contains= "The variable ‚Äò%@‚Äô contains ‚Äò%@‚Äô";
cVariable_LongDescription_DoesNotContain= "The variable ‚Äò%@‚Äô does not contain ‚Äò%@‚Äô";
cVariable_LongDescription_Matches= "The variable ‚Äò%@‚Äô matches ‚Äò%@‚Äô";
cVariable_LongDescription_DoesNotMatch= "The variable ‚Äò%@‚Äô does not match ‚Äò%@‚Äô";
cText_LongDescription_IsEmpty= "The text ‚Äò%@‚Äô is empty";
cText_LongDescription_IsNotEmpty= "The text ‚Äò%@‚Äô is not empty";
cText_LongDescription_Is= "The text ‚Äò%@‚Äô is ‚Äò%@‚Äô";
cText_LongDescription_IsNot= "The text ‚Äò%@‚Äô is not ‚Äò%@‚Äô";
cText_LongDescription_IsBefore= "The text ‚Äò%@‚Äô is before ‚Äò%@‚Äô";
cText_LongDescription_IsAfter= "The text ‚Äò%@‚Äô is after ‚Äò%@‚Äô";
cText_LongDescription_Contains= "The text ‚Äò%@‚Äô contains ‚Äò%@‚Äô";
cText_LongDescription_DoesNotContain= "The text ‚Äò%@‚Äô does not contain ‚Äò%@‚Äô";
cText_LongDescription_Matches= "The text ‚Äò%@‚Äô matches ‚Äò%@‚Äô";
cText_LongDescription_DoesNotMatch= "The text ‚Äò%@‚Äô does not match ‚Äò%@‚Äô";
cCalculationTitle= "Calculation Condition";
cCalculation_LongDescription= "The calculation ‚Äò%@‚Äô returns true (non-zero)";
cMacroTitle= "Macro/Macro Group Condition";
cMacro_LongDescription= "The %@ is %@";
cEnvironmentVariable_LongDescription_IsBefore= "The environment variable ‚Äò%@‚Äô is before ‚Äò%@‚Äô";
cEnvironmentVariable_LongDescription_IsAfter= "The environment variable ‚Äò%@‚Äô is after ‚Äò%@‚Äô";
cPixel_LongDescription_Is= "The pixel at %@,%@ is";
cPixel_LongDescription_IsNot= "The pixel at %@,%@ is not";
cPixel_LongDescription_IsBrighter= "The pixel at %@,%@ is brighter than";
cPixel_LongDescription_IsDarker= "The pixel at %@,%@ is darker than";
cPixel_LongDescription_IsMoreRed= "The pixel at %@,%@ is more red";
cPixel_LongDescription_IsLessRed= "The pixel at %@,%@ is less red";
cPixel_LongDescription_IsMoreGreen= "The pixel at %@,%@ is more green";
cPixel_LongDescription_IsLessGreen= "The pixel at %@,%@ is less green";
cScript_LongDescription_IsBefore= "The script result is before ‚Äò%@‚Äô";
cScript_LongDescription_IsAfter= "The script result is after ‚Äò%@‚Äô";
MacroDoActionListFormat= "Execute macro ‚Äò%@‚Äô from trigger %@";
WebSeverPortError= "The HTTP port number must be between 1024 and 65534.";
WebServerPortDescription= "HTTPS port is one more (%d).";
WebServerBadPortDescription= "Must be 1024-65534.  Still using %d.";
WebServerStatusDisabledDescription= "Web server is disabled.  No remote access.";
WebServerStatusAuthention0Browser0iPhone0Clipboards0 = "Web server is enabled but all access is disabled.";
WebServerStatusAuthention0Browser0iPhone0Clipboards1 = "Web server is enabled for receiving clipboards only.";
WebServerStatusAuthention0Browser1iPhone0Clipboards0 = "Web server is enabled for Public triggers only.";
WebServerStatusAuthention0Browser1iPhone0Clipboards1 = "Web server is enabled for Public triggers and receiving clipboards.";
WebServerStatusAuthention1Browser0iPhone0Clipboards1 = "Web server is enabled for receiving clipboards only (username/password ignored).";
WebServerStatusAuthention1Browser0iPhone1Clipboards0 = "Web server is enabled for iOS access only.";
WebServerStatusAuthention1Browser0iPhone1Clipboards1 = "Web server is enabled for iOS access and receiving clipboards.";
WebServerStatusAuthention1Browser1iPhone0Clipboards0 = "Web server is enabled for public and authenticated browser access.";
WebServerStatusAuthention1Browser1iPhone0Clipboards1 = "Web server is enabled for public & authenticated access and receiving clipboards.";
WebServerStatusAuthention1Browser1iPhone1Clipboards0 = "Web server is enabled for public & authenticated access and iOS access.";
WebServerStatusAuthention1Browser1iPhone1Clipboards1 = "Web server is enabled for public & authenticated & iOS access and receiving clipboards.";
WebServerTriggerDisabledDescription= "Or via the web server but all remote access is disabled.";
WebServerTriggerAuthention0Browser1iPhone0Clipboards0 = "Or via the web server for Public Web triggered macros only.";
WebServerTriggerAuthention1Browser0iPhone1Clipboards0 = "Or via the web server for iOS access only.";
WebServerTriggerAuthention1Browser1iPhone0Clipboards0 = "Or via the web server for public and authenticated browser access.";
WebServerTriggerAuthention1Browser1iPhone1Clipboards0 = "Or via the web server for public, authenticated, and iOS access.";
TutorialOffRails1= "I am afraid you have deviated from the path of this tutorial.  Please try again.";
kInstallFailed= "Keyboard Maestro Install Failed, redirecting to download page";
kDownloadCorrupted= "Keyboard Maestro Download Failed, corrupted file, redirecting to download page";
kDownloadFailed= "Keyboard Maestro Download Failed, redirecting to download page";
FeedbackPostscript= "(I am running Keyboard Maestro %@ on Mac OS X %@ and have so far saved %@)";
MacroGroupNotDeleted_Title= "Macro Group Not Deleted";
MacroGroupNotDeleted_DescriptionWith0MacrosAnd0MacroGroups= "Nothing was deleted, and one or more Macro Groups were not deleted because they contained macros that were not selected.";
MacroGroupNotDeleted_DescriptionWith1MacrosAnd0MacroGroups= "One macro was deleted but one or more Macro Groups were not deleted because they contained macros that were not selected.";
MacroGroupNotDeleted_DescriptionWith2MacrosAnd0MacroGroups= "%1$d macros were deleted, but one or more Macro Groups were not deleted because they contained macros that were not selected.";
MacroGroupNotDeleted_DescriptionWith0MacrosAnd1MacroGroups= "A Macro Group was deleted, but one or more Macro Groups were not deleted because they contained macros that were not selected.";
MacroGroupNotDeleted_DescriptionWith1MacrosAnd1MacroGroups= "A Macro Group and a macro were deleted but one or more Macro Groups were not deleted because they contained macros that were not selected.";
MacroGroupNotDeleted_DescriptionWith2MacrosAnd1MacroGroups= "A Macro Group and %1$d macros were deleted, but one or more Macro Groups were not deleted because they contained macros that were not selected.";
MacroGroupNotDeleted_DescriptionWith0MacrosAnd2MacroGroups= "%2$d Macro Groups was deleted, but one or more Macro Groups were not deleted because they contained macros that were not selected.";
MacroGroupNotDeleted_DescriptionWith1MacrosAnd2MacroGroups= "%2$d Macro Groups and a macro were deleted but one or more Macro Groups were not deleted because they contained macros that were not selected.";
MacroGroupNotDeleted_DescriptionWith2MacrosAnd2MacroGroups= "%2$d Macro Groups and %1$d macros were deleted, but one or more Macro Groups were not deleted because they contained macros that were not selected.";
GlobalMacroGroupNotDeleted_Title= "Global Macro Group Not Deleted";
GlobalMacroGroupNotDeleted_DescriptionWith0MacrosAnd0MacroGroups= "Nothing was deleted, and the Global Macro Groups is not allowed to be deleted (you can change it to Inactive if you desire).";
GlobalMacroGroupNotDeleted_DescriptionWith1MacrosAnd0MacroGroups= "One macro was deleted but the Global Macro Groups is not allowed to be deleted (you can change it to Inactive if you desire).";
GlobalMacroGroupNotDeleted_DescriptionWith2MacrosAnd0MacroGroups= "%1$d macros were deleted, but the Global Macro Groups is not allowed to be deleted (you can change it to Inactive if you desire).";
GlobalMacroGroupNotDeleted_DescriptionWith0MacrosAnd1MacroGroups= "A Macro Group was deleted, but the Global Macro Groups is not allowed to be deleted (you can change it to Inactive if you desire).";
GlobalMacroGroupNotDeleted_DescriptionWith1MacrosAnd1MacroGroups= "A Macro Group and a macro were deleted but the Global Macro Groups is not allowed to be deleted (you can change it to Inactive if you desire).";
GlobalMacroGroupNotDeleted_DescriptionWith2MacrosAnd1MacroGroups= "A Macro Group and %1$d macros were deleted, but the Global Macro Groups is not allowed to be deleted (you can change it to Inactive if you desire).";
GlobalMacroGroupNotDeleted_DescriptionWith0MacrosAnd2MacroGroups= "%2$d Macro Groups was deleted, but the Global Macro Groups is not allowed to be deleted (you can change it to Inactive if you desire).";
GlobalMacroGroupNotDeleted_DescriptionWith1MacrosAnd2MacroGroups= "%2$d Macro Groups and a macro were deleted but the Global Macro Groups is not allowed to be deleted (you can change it to Inactive if you desire).";
GlobalMacroGroupNotDeleted_DescriptionWith2MacrosAnd2MacroGroups= "%2$d Macro Groups and %1$d macros were deleted, but the Global Macro Groups is not allowed to be deleted (you can change it to Inactive if you desire).";
kInsertFunction = "Math
DOW([time]):DOW - Current or Specified Day of the Week (Sunday=1)
NoPreferencePanesAvailable = "No Preference Panes Available";
NumberPadSubmenu = "Key Pad";
FunctionKeySubmenu = "Function Key";
TabUniCharLong= "Tab";
DeleteUniCharShort= "‚å´";
EscapeUniCharShort= "‚éã";
ClearUniCharShort= "‚åß";
DeleteRightUniCharShort= "‚å¶";
PageUpUniCharShort= "‚áû";
PageDownUniCharShort= "‚áü";
HelpUniCharShort= "?";
HomeUniCharShort= "‚ÜñÔ∏é";
EndUniCharShort= "‚ÜòÔ∏é";
LeftArrowUniCharShort= "‚Üê";
RightArrowUniCharShort= "‚Üí";
DownArrowUniCharShort= "‚Üì";
UpArrowUniCharShort= "‚Üë";
ISOSectionUniCharShort= "¬ß";
ISOSectionUniCharLong= "Section Sign";
JISYenUniCharShort= "¬•";
JISYenUniCharLong= "JIS Yen";
JISUnderscoreUniCharShort= "‚íø_";
JISUnderscoreUniCharLong= "JIS Underscore";
JISKeypadCommaUniCharShort= "‚íø‚äû,";
JISKeypadCommaUniCharLong= "JIS Key Pad ,";
JISKeypadCommaUniCharName= "JIS Key Pad Comma";
JISEisuUniCharShort= "Eisu";
JISEisuUniCharLong= "JIS Eisu";
JISKanaUniCharShort= "Kana";
JISKanaUniCharLong= "JIS Kana";
NumberPadFormatShort= "‚äû%@";
NumberPadFormatLong= "Key Pad %@";
WidthCharacter = "‚Üî";
HeightCharacter = "‚Üï";
DownToCenterArrowCharacter = "‚§ì";
kCheckLocalizedStrings= "GOOD";
MenuGlyph6F = "F1";
MenuGlyph70 = "F2";
MenuGlyph71 = "F3";
MenuGlyph72 = "F4";
MenuGlyph73 = "F5";
MenuGlyph74 = "F6";
MenuGlyph75 = "F7";
MenuGlyph76 = "F8";
MenuGlyph77 = "F9";
MenuGlyph78 = "F10";
MenuGlyph79 = "F11";
MenuGlyph7A = "F12";
MenuGlyph87 = "F13";
MenuGlyph88 = "F14";
MenuGlyph89 = "F15";
MenuGlyph8F = "F16";
MenuGlyph90 = "F17";
MenuGlyph91 = "F18";
MenuGlyph92 = "F19";